From: <support@pokerstars.com>
To: <starstealer@comcast.net>
Subject: PokerStars Hand History Request - tournament #376033
Date: Saturday, October 25, 2003 4:37 PM

Transcript for tournament #376033 requested by Starstealer(starstealer@comcast.net)
*********** # 1 **************
PokerStars Game #136508953: Tournament #376033, Hold'em Limit - Level I (20/40) - 2003/10/04 - 23:59:00 (ET)
Table '376033 3' Seat #1 is the button
Seat 1: Starstealer (1500 in chips) 
Seat 2: bjackmurray (1500 in chips) 
Seat 3: NoleSAK (1500 in chips) 
Seat 5: bluesteele (1500 in chips) 
Seat 6: catdaddy43 (1500 in chips) is sitting out
Seat 7: jurneyman (1500 in chips) 
Seat 8: TheBigAceT (1500 in chips) is sitting out
Seat 9: Perc60 (1500 in chips) 
bjackmurray: posts small blind 10
NoleSAK: posts big blind 20
*** HOLE CARDS ***
Dealt to Starstealer [8s 4s]
bluesteele: folds 
catdaddy43: folds 
jurneyman: calls 20
TheBigAceT: folds 
Perc60: folds 
Perc60 is sitting out
Starstealer: folds 
bjackmurray: folds 
NoleSAK: checks 
*** FLOP *** [2s Qd 8h]
NoleSAK: checks 
jurneyman: bets 20
NoleSAK: folds 
jurneyman collected 50 from  pot
jurneyman: doesn't show hand 
*** SUMMARY ***
Total pot 50 | Rake 0 
Board [2s Qd 8h]
Seat 1: Starstealer (button) folded before Flop (didn't bet)
Seat 2: bjackmurray (small blind) folded before Flop
Seat 3: NoleSAK (big blind) folded on the Flop
Seat 5: bluesteele folded before Flop (didn't bet)
Seat 6: catdaddy43 folded before Flop (didn't bet)
Seat 7: jurneyman collected (50)
Seat 8: TheBigAceT folded before Flop (didn't bet)
Seat 9: Perc60 folded before Flop (didn't bet)

*********** # 2 **************
PokerStars Game #136509612: Tournament #376033, Hold'em Limit - Level I (20/40) - 2003/10/04 - 23:59:39 (ET)
Table '376033 3' Seat #2 is the button
Seat 1: Starstealer (1500 in chips) 
Seat 2: bjackmurray (1490 in chips) 
Seat 3: NoleSAK (1480 in chips) 
Seat 5: bluesteele (1500 in chips) 
Seat 6: catdaddy43 (1500 in chips) is sitting out
Seat 7: jurneyman (1530 in chips) 
Seat 8: TheBigAceT (1500 in chips) is sitting out
Seat 9: Perc60 (1500 in chips) is sitting out
NoleSAK: posts small blind 10
bluesteele: posts big blind 20
*** HOLE CARDS ***
Dealt to Starstealer [Ah Kh]
catdaddy43: folds 
jurneyman: raises 20 to 40
TheBigAceT: folds 
Perc60: folds 
Starstealer: raises 20 to 60
bjackmurray: folds 
NoleSAK: folds 
bluesteele: folds 
jurneyman: raises 20 to 80
Betting is capped
Starstealer: calls 20
*** FLOP *** [Jc 7s 5d]
jurneyman: bets 20
Starstealer: calls 20
*** TURN *** [Jc 7s 5d] [Ks]
jurneyman: checks 
Starstealer: checks 
*** RIVER *** [Jc 7s 5d Ks] [Js]
jurneyman: checks 
Starstealer: bets 40
Perc60 has returned
jurneyman: calls 40
*** SHOW DOWN ***
Starstealer: shows [Ah Kh] (two pair, Kings and Jacks)
jurneyman: mucks hand 
Starstealer collected 310 from  pot
TheBigAceT is connected 
*** SUMMARY ***
Total pot 310 | Rake 0 
Board [Jc 7s 5d Ks Js]
Seat 1: Starstealer showed [Ah Kh] and won (310) with two pair, Kings and Jacks
Seat 2: bjackmurray (button) folded before Flop (didn't bet)
Seat 3: NoleSAK (small blind) folded before Flop
Seat 5: bluesteele (big blind) folded before Flop
Seat 6: catdaddy43 folded before Flop (didn't bet)
Seat 7: jurneyman mucked [Ad 9s] - a pair of Jacks
Seat 8: TheBigAceT folded before Flop (didn't bet)
Seat 9: Perc60 folded before Flop (didn't bet)

*********** # 3 **************
PokerStars Game #136510846: Tournament #376033, Hold'em Limit - Level I (20/40) - 2003/10/05 - 00:00:52 (ET)
Table '376033 3' Seat #3 is the button
Seat 1: Starstealer (1670 in chips) 
Seat 2: bjackmurray (1490 in chips) 
Seat 3: NoleSAK (1470 in chips) 
Seat 5: bluesteele (1480 in chips) 
Seat 6: catdaddy43 (1500 in chips) is sitting out
Seat 7: jurneyman (1390 in chips) 
Seat 8: TheBigAceT (1500 in chips) is sitting out
Seat 9: Perc60 (1500 in chips) 
bluesteele: posts small blind 10
catdaddy43: posts big blind 20
*** HOLE CARDS ***
Dealt to Starstealer [4d 5h]
TheBigAceT has returned
jurneyman: calls 20
TheBigAceT: folds 
Perc60: calls 20
Starstealer: folds 
bjackmurray: folds 
NoleSAK: folds 
bluesteele: calls 10
catdaddy43: folds 
*** FLOP *** [Tc Jd Js]
bluesteele: bets 20
jurneyman: calls 20
Perc60: raises 20 to 40
bluesteele: calls 20
jurneyman: calls 20
*** TURN *** [Tc Jd Js] [2d]
bluesteele: bets 40
jurneyman: folds 
Perc60: raises 40 to 80
bluesteele: calls 40
*** RIVER *** [Tc Jd Js 2d] [Qc]
bluesteele: bets 40
Perc60: raises 40 to 80
bluesteele: raises 40 to 120
Perc60: folds 
bluesteele collected 520 from  pot
bluesteele: doesn't show hand 
*** SUMMARY ***
Total pot 520 | Rake 0 
Board [Tc Jd Js 2d Qc]
Seat 1: Starstealer folded before Flop (didn't bet)
Seat 2: bjackmurray folded before Flop (didn't bet)
Seat 3: NoleSAK (button) folded before Flop (didn't bet)
Seat 5: bluesteele (small blind) collected (520)
Seat 6: catdaddy43 (big blind) folded before Flop
Seat 7: jurneyman folded on the Turn
Seat 8: TheBigAceT folded before Flop (didn't bet)
Seat 9: Perc60 folded on the River

*********** # 4 **************
PokerStars Game #136512153: Tournament #376033, Hold'em Limit - Level I (20/40) - 2003/10/05 - 00:02:10 (ET)
Table '376033 3' Seat #5 is the button
Seat 1: Starstealer (1670 in chips) 
Seat 2: bjackmurray (1490 in chips) 
Seat 3: NoleSAK (1470 in chips) 
Seat 5: bluesteele (1780 in chips) 
Seat 6: catdaddy43 (1480 in chips) is sitting out
Seat 7: jurneyman (1330 in chips) 
Seat 8: TheBigAceT (1500 in chips) 
Seat 9: Perc60 (1280 in chips) 
catdaddy43: posts small blind 10
jurneyman: posts big blind 20
*** HOLE CARDS ***
Dealt to Starstealer [9s Qs]
TheBigAceT: folds 
Perc60: calls 20
Starstealer: folds 
bjackmurray: calls 20
NoleSAK: raises 20 to 40
bluesteele: calls 40
catdaddy43: folds 
jurneyman: calls 20
Perc60: calls 20
bjackmurray: calls 20
*** FLOP *** [Ks As Th]
jurneyman: checks 
Perc60: bets 20
bjackmurray: calls 20
NoleSAK: calls 20
bluesteele: calls 20
jurneyman: calls 20
*** TURN *** [Ks As Th] [Jc]
jurneyman: checks 
Perc60: bets 40
bjackmurray: calls 40
NoleSAK: calls 40
bluesteele: folds 
jurneyman: folds 
*** RIVER *** [Ks As Th Jc] [8c]
Perc60: checks 
bjackmurray: bets 40
NoleSAK: folds 
Perc60: calls 40
*** SHOW DOWN ***
bjackmurray: shows [Kc 2h] (a pair of Kings)
Perc60: shows [Td Ac] (two pair, Aces and Tens)
Perc60 collected 510 from  pot
*** SUMMARY ***
Total pot 510 | Rake 0 
Board [Ks As Th Jc 8c]
Seat 1: Starstealer folded before Flop (didn't bet)
Seat 2: bjackmurray showed [Kc 2h] and lost with a pair of Kings
Seat 3: NoleSAK folded on the River
Seat 5: bluesteele (button) folded on the Turn
Seat 6: catdaddy43 (small blind) folded before Flop
Seat 7: jurneyman (big blind) folded on the Turn
Seat 8: TheBigAceT folded before Flop (didn't bet)
Seat 9: Perc60 showed [Td Ac] and won (510) with two pair, Aces and Tens

*********** # 5 **************
PokerStars Game #136513644: Tournament #376033, Hold'em Limit - Level I (20/40) - 2003/10/05 - 00:03:38 (ET)
Table '376033 3' Seat #6 is the button
Seat 1: Starstealer (1670 in chips) 
Seat 2: bjackmurray (1350 in chips) 
Seat 3: NoleSAK (1370 in chips) 
Seat 5: bluesteele (1720 in chips) 
Seat 6: catdaddy43 (1470 in chips) is sitting out
Seat 7: jurneyman (1270 in chips) 
Seat 8: TheBigAceT (1500 in chips) 
Seat 9: Perc60 (1650 in chips) 
jurneyman: posts small blind 10
TheBigAceT: posts big blind 20
*** HOLE CARDS ***
Dealt to Starstealer [4h 7d]
Perc60: folds 
Starstealer: folds 
bjackmurray: calls 20
NoleSAK: folds 
bluesteele: calls 20
catdaddy43: folds 
jurneyman: calls 10
TheBigAceT: checks 
*** FLOP *** [9s Qd 7c]
jurneyman: checks 
TheBigAceT: checks 
bjackmurray: checks 
bluesteele: bets 20
jurneyman: calls 20
TheBigAceT: folds 
bjackmurray: calls 20
*** TURN *** [9s Qd 7c] [3s]
jurneyman: checks 
bjackmurray: checks 
bluesteele: bets 40
jurneyman: calls 40
bjackmurray: folds 
*** RIVER *** [9s Qd 7c 3s] [9c]
jurneyman: checks 
bluesteele: checks 
*** SHOW DOWN ***
jurneyman: shows [2h Ad] (a pair of Nines)
bluesteele: mucks hand 
jurneyman collected 220 from  pot
*** SUMMARY ***
Total pot 220 | Rake 0 
Board [9s Qd 7c 3s 9c]
Seat 1: Starstealer folded before Flop (didn't bet)
Seat 2: bjackmurray folded on the Turn
Seat 3: NoleSAK folded before Flop (didn't bet)
Seat 5: bluesteele mucked [Th Kc] - a pair of Nines
Seat 6: catdaddy43 (button) folded before Flop (didn't bet)
Seat 7: jurneyman (small blind) showed [2h Ad] and won (220) with a pair of Nines
Seat 8: TheBigAceT (big blind) folded on the Flop
Seat 9: Perc60 folded before Flop (didn't bet)

*********** # 6 **************
PokerStars Game #136514642: Tournament #376033, Hold'em Limit - Level I (20/40) - 2003/10/05 - 00:04:39 (ET)
Table '376033 3' Seat #7 is the button
Seat 1: Starstealer (1670 in chips) 
Seat 2: bjackmurray (1310 in chips) 
Seat 3: NoleSAK (1370 in chips) 
Seat 5: bluesteele (1640 in chips) 
Seat 6: catdaddy43 (1470 in chips) is sitting out
Seat 7: jurneyman (1410 in chips) 
Seat 8: TheBigAceT (1480 in chips) 
Seat 9: Perc60 (1650 in chips) 
TheBigAceT: posts small blind 10
Perc60: posts big blind 20
*** HOLE CARDS ***
Dealt to Starstealer [Kh 8s]
Starstealer: folds 
bjackmurray: folds 
NoleSAK: calls 20
bluesteele: calls 20
catdaddy43: folds 
jurneyman: folds 
TheBigAceT: folds 
Perc60: checks 
*** FLOP *** [Qs 4d Ts]
Perc60: checks 
NoleSAK: bets 20
bluesteele: calls 20
Perc60: calls 20
*** TURN *** [Qs 4d Ts] [Ah]
Perc60: checks 
NoleSAK: bets 40
bluesteele: folds 
Perc60: calls 40
*** RIVER *** [Qs 4d Ts Ah] [7h]
Perc60: checks 
NoleSAK: bets 40
Perc60: calls 40
*** SHOW DOWN ***
NoleSAK: shows [4c Qh] (two pair, Queens and Fours)
Perc60: mucks hand 
NoleSAK collected 290 from  pot
*** SUMMARY ***
Total pot 290 | Rake 0 
Board [Qs 4d Ts Ah 7h]
Seat 1: Starstealer folded before Flop (didn't bet)
Seat 2: bjackmurray folded before Flop (didn't bet)
Seat 3: NoleSAK showed [4c Qh] and won (290) with two pair, Queens and Fours
Seat 5: bluesteele folded on the Turn
Seat 6: catdaddy43 folded before Flop (didn't bet)
Seat 7: jurneyman (button) folded before Flop (didn't bet)
Seat 8: TheBigAceT (small blind) folded before Flop
Seat 9: Perc60 (big blind) mucked [Ks 5h] - high card Ace

*********** # 7 **************
PokerStars Game #136515599: Tournament #376033, Hold'em Limit - Level I (20/40) - 2003/10/05 - 00:05:37 (ET)
Table '376033 3' Seat #8 is the button
Seat 1: Starstealer (1670 in chips) 
Seat 2: bjackmurray (1310 in chips) 
Seat 3: NoleSAK (1540 in chips) 
Seat 5: bluesteele (1600 in chips) 
Seat 6: catdaddy43 (1470 in chips) is sitting out
Seat 7: jurneyman (1410 in chips) 
Seat 8: TheBigAceT (1470 in chips) 
Seat 9: Perc60 (1530 in chips) 
Perc60: posts small blind 10
Starstealer: posts big blind 20
*** HOLE CARDS ***
Dealt to Starstealer [Qh 3c]
bjackmurray: folds 
NoleSAK: calls 20
bluesteele: calls 20
catdaddy43: folds 
jurneyman: folds 
TheBigAceT: calls 20
Perc60: calls 10
Starstealer: checks 
*** FLOP *** [5c Kh Qd]
Perc60: checks 
Starstealer: checks 
NoleSAK: checks 
bluesteele: bets 20
TheBigAceT: calls 20
Perc60: calls 20
Starstealer: folds 
NoleSAK: folds 
*** TURN *** [5c Kh Qd] [5h]
Perc60: checks 
bluesteele: bets 40
TheBigAceT: folds 
Perc60: folds 
bluesteele collected 160 from  pot
bluesteele: doesn't show hand 
*** SUMMARY ***
Total pot 160 | Rake 0 
Board [5c Kh Qd 5h]
Seat 1: Starstealer (big blind) folded on the Flop
Seat 2: bjackmurray folded before Flop (didn't bet)
Seat 3: NoleSAK folded on the Flop
Seat 5: bluesteele collected (160)
Seat 6: catdaddy43 folded before Flop (didn't bet)
Seat 7: jurneyman folded before Flop (didn't bet)
Seat 8: TheBigAceT (button) folded on the Turn
Seat 9: Perc60 (small blind) folded on the Turn

*********** # 8 **************
PokerStars Game #136516848: Tournament #376033, Hold'em Limit - Level I (20/40) - 2003/10/05 - 00:06:51 (ET)
Table '376033 3' Seat #9 is the button
Seat 1: Starstealer (1650 in chips) 
Seat 2: bjackmurray (1310 in chips) 
Seat 3: NoleSAK (1520 in chips) 
Seat 5: bluesteele (1720 in chips) 
Seat 6: catdaddy43 (1470 in chips) is sitting out
Seat 7: jurneyman (1410 in chips) 
Seat 8: TheBigAceT (1430 in chips) 
Seat 9: Perc60 (1490 in chips) 
Starstealer: posts small blind 10
bjackmurray: posts big blind 20
*** HOLE CARDS ***
Dealt to Starstealer [Kh 2h]
NoleSAK: calls 20
bluesteele: calls 20
catdaddy43: folds 
jurneyman: calls 20
TheBigAceT: calls 20
Perc60: calls 20
Starstealer: calls 10
bjackmurray: checks 
*** FLOP *** [6h Ks 2d]
Starstealer: bets 20
bjackmurray: folds 
NoleSAK: calls 20
bluesteele: folds 
jurneyman: raises 20 to 40
TheBigAceT: folds 
Perc60: folds 
Starstealer: calls 20
NoleSAK: calls 20
*** TURN *** [6h Ks 2d] [6c]
Starstealer: checks 
NoleSAK: checks 
jurneyman: bets 40
Starstealer: calls 40
NoleSAK: folds 
*** RIVER *** [6h Ks 2d 6c] [2s]
Starstealer: bets 40
jurneyman: raises 40 to 80
Starstealer: calls 40
*** SHOW DOWN ***
jurneyman: shows [2c Ah] (a full house, Deuces full of Sixes)
Starstealer: shows [Kh 2h] (a full house, Deuces full of Kings)
Starstealer collected 500 from  pot
*** SUMMARY ***
Total pot 500 | Rake 0 
Board [6h Ks 2d 6c 2s]
Seat 1: Starstealer (small blind) showed [Kh 2h] and won (500) with a full house, Deuces full of Kings
Seat 2: bjackmurray (big blind) folded on the Flop
Seat 3: NoleSAK folded on the Turn
Seat 5: bluesteele folded on the Flop
Seat 6: catdaddy43 folded before Flop (didn't bet)
Seat 7: jurneyman showed [2c Ah] and lost with a full house, Deuces full of Sixes
Seat 8: TheBigAceT folded on the Flop
Seat 9: Perc60 (button) folded on the Flop

*********** # 9 **************
PokerStars Game #136518243: Tournament #376033, Hold'em Limit - Level I (20/40) - 2003/10/05 - 00:08:16 (ET)
Table '376033 3' Seat #1 is the button
Seat 1: Starstealer (1970 in chips) 
Seat 2: bjackmurray (1290 in chips) 
Seat 3: NoleSAK (1460 in chips) 
Seat 5: bluesteele (1700 in chips) 
Seat 6: catdaddy43 (1470 in chips) is sitting out
Seat 7: jurneyman (1230 in chips) 
Seat 8: TheBigAceT (1410 in chips) 
Seat 9: Perc60 (1470 in chips) 
bjackmurray: posts small blind 10
NoleSAK: posts big blind 20
*** HOLE CARDS ***
Dealt to Starstealer [9s Ac]
bluesteele: calls 20
catdaddy43: folds 
jurneyman: calls 20
TheBigAceT: folds 
Perc60: calls 20
Starstealer: folds 
bjackmurray: calls 10
NoleSAK: checks 
*** FLOP *** [3h Jh Kc]
bjackmurray: checks 
NoleSAK: checks 
bluesteele: checks 
jurneyman: bets 20
Perc60: raises 20 to 40
bjackmurray: calls 40
NoleSAK: folds 
bluesteele: calls 40
jurneyman: raises 20 to 60
awaone is connected 
Perc60: calls 20
bjackmurray: calls 20
bluesteele: calls 20
*** TURN *** [3h Jh Kc] [Jc]
bjackmurray: checks 
bluesteele: checks 
jurneyman: bets 40
Perc60: calls 40
bjackmurray: folds 
bluesteele: folds 
*** RIVER *** [3h Jh Kc Jc] [4d]
jurneyman: checks 
Perc60: checks 
*** SHOW DOWN ***
jurneyman: shows [3c Tc] (two pair, Jacks and Threes)
Perc60: shows [Kd Td] (two pair, Kings and Jacks)
Perc60 collected 420 from  pot
*** SUMMARY ***
Total pot 420 | Rake 0 
Board [3h Jh Kc Jc 4d]
Seat 1: Starstealer (button) folded before Flop (didn't bet)
Seat 2: bjackmurray (small blind) folded on the Turn
Seat 3: NoleSAK (big blind) folded on the Flop
Seat 5: bluesteele folded on the Turn
Seat 6: catdaddy43 folded before Flop (didn't bet)
Seat 7: jurneyman showed [3c Tc] and lost with two pair, Jacks and Threes
Seat 8: TheBigAceT folded before Flop (didn't bet)
Seat 9: Perc60 showed [Kd Td] and won (420) with two pair, Kings and Jacks

*********** # 10 **************
PokerStars Game #136519741: Tournament #376033, Hold'em Limit - Level I (20/40) - 2003/10/05 - 00:09:52 (ET)
Table '376033 3' Seat #2 is the button
Seat 1: Starstealer (1970 in chips) 
Seat 2: bjackmurray (1210 in chips) 
Seat 3: NoleSAK (1440 in chips) 
Seat 4: awaone (1910 in chips) 
Seat 5: bluesteele (1620 in chips) 
Seat 6: catdaddy43 (1470 in chips) is sitting out
Seat 7: jurneyman (1110 in chips) 
Seat 8: TheBigAceT (1410 in chips) 
Seat 9: Perc60 (1770 in chips) 
NoleSAK: posts small blind 10
awaone: posts big blind 20
*** HOLE CARDS ***
Dealt to Starstealer [3c Ah]
bluesteele: folds 
catdaddy43: folds 
jurneyman: raises 20 to 40
TheBigAceT: folds 
Perc60: folds 
Starstealer: folds 
bjackmurray: folds 
NoleSAK: calls 30
awaone: calls 20
*** FLOP *** [8s Td Kh]
NoleSAK: bets 20
awaone: calls 20
jurneyman: calls 20
*** TURN *** [8s Td Kh] [3s]
NoleSAK: bets 40
awaone: folds 
jurneyman: folds 
NoleSAK collected 180 from  pot
*** SUMMARY ***
Total pot 180 | Rake 0 
Board [8s Td Kh 3s]
Seat 1: Starstealer folded before Flop (didn't bet)
Seat 2: bjackmurray (button) folded before Flop (didn't bet)
Seat 3: NoleSAK (small blind) collected (180)
Seat 4: awaone (big blind) folded on the Turn
Seat 5: bluesteele folded before Flop (didn't bet)
Seat 6: catdaddy43 folded before Flop (didn't bet)
Seat 7: jurneyman folded on the Turn
Seat 8: TheBigAceT folded before Flop (didn't bet)
Seat 9: Perc60 folded before Flop (didn't bet)

*********** # 11 **************
PokerStars Game #136520718: Tournament #376033, Hold'em Limit - Level I (20/40) - 2003/10/05 - 00:10:51 (ET)
Table '376033 3' Seat #3 is the button
Seat 1: Starstealer (1970 in chips) 
Seat 2: bjackmurray (1210 in chips) 
Seat 3: NoleSAK (1560 in chips) 
Seat 4: awaone (1850 in chips) 
Seat 5: bluesteele (1620 in chips) 
Seat 6: catdaddy43 (1470 in chips) is sitting out
Seat 7: jurneyman (1050 in chips) 
Seat 8: TheBigAceT (1410 in chips) 
Seat 9: Perc60 (1770 in chips) 
awaone: posts small blind 10
bluesteele: posts big blind 20
*** HOLE CARDS ***
Dealt to Starstealer [9d Qd]
catdaddy43: folds 
jurneyman: calls 20
TheBigAceT: folds 
Perc60: calls 20
Starstealer: folds 
bjackmurray: calls 20
NoleSAK: calls 20
awaone: calls 10
bluesteele: checks 
*** FLOP *** [5d Ts 8d]
awaone: checks 
bluesteele: bets 20
jurneyman: calls 20
Perc60: raises 20 to 40
bjackmurray: calls 40
NoleSAK: raises 20 to 60
awaone: folds 
bluesteele: calls 40
jurneyman: calls 40
Perc60: calls 20
bjackmurray: calls 20
*** TURN *** [5d Ts 8d] [7c]
bluesteele: checks 
jurneyman: checks 
Perc60: checks 
bjackmurray: checks 
NoleSAK: bets 40
bluesteele: calls 40
jurneyman: calls 40
Perc60: calls 40
bjackmurray: calls 40
*** RIVER *** [5d Ts 8d 7c] [4s]
bluesteele: checks 
jurneyman: checks 
Perc60: checks 
bjackmurray: checks 
NoleSAK: bets 40
bluesteele: calls 40
jurneyman: folds 
Perc60: folds 
bjackmurray: folds 
*** SHOW DOWN ***
NoleSAK: shows [Tc Qs] (a pair of Tens)
bluesteele: shows [5h 8s] (two pair, Eights and Fives)
bluesteele collected 700 from  pot
*** SUMMARY ***
Total pot 700 | Rake 0 
Board [5d Ts 8d 7c 4s]
Seat 1: Starstealer folded before Flop (didn't bet)
Seat 2: bjackmurray folded on the River
Seat 3: NoleSAK (button) showed [Tc Qs] and lost with a pair of Tens
Seat 4: awaone (small blind) folded on the Flop
Seat 5: bluesteele (big blind) showed [5h 8s] and won (700) with two pair, Eights and Fives
Seat 6: catdaddy43 folded before Flop (didn't bet)
Seat 7: jurneyman folded on the River
Seat 8: TheBigAceT folded before Flop (didn't bet)
Seat 9: Perc60 folded on the River

*********** # 12 **************
PokerStars Game #136522426: Tournament #376033, Hold'em Limit - Level I (20/40) - 2003/10/05 - 00:12:36 (ET)
Table '376033 3' Seat #4 is the button
Seat 1: Starstealer (1970 in chips) 
Seat 2: bjackmurray (1090 in chips) 
Seat 3: NoleSAK (1400 in chips) 
Seat 4: awaone (1830 in chips) 
Seat 5: bluesteele (2160 in chips) 
Seat 6: catdaddy43 (1470 in chips) is sitting out
Seat 7: jurneyman (930 in chips) 
Seat 8: TheBigAceT (1410 in chips) 
Seat 9: Perc60 (1650 in chips) 
bluesteele: posts small blind 10
catdaddy43: posts big blind 20
*** HOLE CARDS ***
Dealt to Starstealer [Ac 7d]
NoleSAK said, "vn"
jurneyman: calls 20
TheBigAceT: folds 
Perc60: calls 20
Starstealer: folds 
bjackmurray: folds 
NoleSAK: calls 20
awaone: folds 
bluesteele: calls 10
catdaddy43: folds 
*** FLOP *** [5h Kh 9s]
bluesteele: checks 
jurneyman: bets 20
Perc60: calls 20
NoleSAK: folds 
bluesteele: calls 20
*** TURN *** [5h Kh 9s] [8c]
bluesteele: checks 
jurneyman: bets 40
Perc60: raises 40 to 80
bluesteele: folds 
jurneyman: raises 40 to 120
Perc60: calls 40
*** RIVER *** [5h Kh 9s 8c] [6d]
jurneyman: checks 
Perc60: checks 
*** SHOW DOWN ***
jurneyman: shows [Js Td] (high card King)
Perc60: shows [8s 5s] (two pair, Eights and Fives)
Perc60 collected 400 from  pot
*** SUMMARY ***
Total pot 400 | Rake 0 
Board [5h Kh 9s 8c 6d]
Seat 1: Starstealer folded before Flop (didn't bet)
Seat 2: bjackmurray folded before Flop (didn't bet)
Seat 3: NoleSAK folded on the Flop
Seat 4: awaone (button) folded before Flop (didn't bet)
Seat 5: bluesteele (small blind) folded on the Turn
Seat 6: catdaddy43 (big blind) folded before Flop
Seat 7: jurneyman showed [Js Td] and lost with high card King
Seat 8: TheBigAceT folded before Flop (didn't bet)
Seat 9: Perc60 showed [8s 5s] and won (400) with two pair, Eights and Fives

*********** # 13 **************
PokerStars Game #136523525: Tournament #376033, Hold'em Limit - Level I (20/40) - 2003/10/05 - 00:13:45 (ET)
Table '376033 3' Seat #5 is the button
Seat 1: Starstealer (1970 in chips) 
Seat 2: bjackmurray (1090 in chips) 
Seat 3: NoleSAK (1380 in chips) 
Seat 4: awaone (1830 in chips) 
Seat 5: bluesteele (2120 in chips) 
Seat 6: catdaddy43 (1450 in chips) is sitting out
Seat 7: jurneyman (770 in chips) 
Seat 8: TheBigAceT (1410 in chips) 
Seat 9: Perc60 (1890 in chips) 
catdaddy43: posts small blind 10
jurneyman: posts big blind 20
*** HOLE CARDS ***
Dealt to Starstealer [Ts 6c]
TheBigAceT: folds 
Perc60: calls 20
Starstealer: folds 
jurneyman said, "nh"
bjackmurray: calls 20
NoleSAK: calls 20
awaone: calls 20
bluesteele: calls 20
catdaddy43: folds 
jurneyman: checks 
*** FLOP *** [Jc 6d As]
jurneyman: checks 
Perc60: checks 
bjackmurray: bets 20
NoleSAK: folds 
awaone: calls 20
bluesteele: calls 20
jurneyman: folds 
Perc60: calls 20
*** TURN *** [Jc 6d As] [9s]
Perc60: checks 
bjackmurray: bets 40
awaone: calls 40
bluesteele: calls 40
Perc60: calls 40
*** RIVER *** [Jc 6d As 9s] [4h]
Perc60: checks 
bjackmurray: bets 40
awaone: calls 40
bluesteele: calls 40
Perc60: folds 
*** SHOW DOWN ***
bjackmurray: shows [Jd 5d] (a pair of Jacks)
awaone: shows [5c Ac] (a pair of Aces)
bluesteele: shows [Ad 9c] (two pair, Aces and Nines)
bluesteele collected 490 from  pot
*** SUMMARY ***
Total pot 490 | Rake 0 
Board [Jc 6d As 9s 4h]
Seat 1: Starstealer folded before Flop (didn't bet)
Seat 2: bjackmurray showed [Jd 5d] and lost with a pair of Jacks
Seat 3: NoleSAK folded on the Flop
Seat 4: awaone showed [5c Ac] and lost with a pair of Aces
Seat 5: bluesteele (button) showed [Ad 9c] and won (490) with two pair, Aces and Nines
Seat 6: catdaddy43 (small blind) folded before Flop
Seat 7: jurneyman (big blind) folded on the Flop
Seat 8: TheBigAceT folded before Flop (didn't bet)
Seat 9: Perc60 folded on the River

*********** # 14 **************
PokerStars Game #136524717: Tournament #376033, Hold'em Limit - Level II (30/60) - 2003/10/05 - 00:14:59 (ET)
Table '376033 3' Seat #6 is the button
Seat 1: Starstealer (1970 in chips) 
Seat 2: bjackmurray (970 in chips) 
Seat 3: NoleSAK (1360 in chips) 
Seat 4: awaone (1710 in chips) 
Seat 5: bluesteele (2490 in chips) 
Seat 6: catdaddy43 (1440 in chips) is sitting out
Seat 7: jurneyman (750 in chips) 
Seat 8: TheBigAceT (1410 in chips) 
Seat 9: Perc60 (1810 in chips) 
jurneyman: posts small blind 15
TheBigAceT: posts big blind 30
*** HOLE CARDS ***
Dealt to Starstealer [3h Jc]
Perc60: folds 
Starstealer: folds 
bjackmurray: folds 
NoleSAK: folds 
awaone: calls 30
bluesteele: calls 30
catdaddy43: folds 
jurneyman: raises 30 to 60
TheBigAceT: calls 30
awaone: calls 30
bluesteele: calls 30
*** FLOP *** [8h 5s Qc]
jurneyman: checks 
TheBigAceT: checks 
awaone: checks 
bluesteele: bets 30
jurneyman: calls 30
TheBigAceT: calls 30
awaone: folds 
*** TURN *** [8h 5s Qc] [2c]
jurneyman: checks 
TheBigAceT: checks 
bluesteele: bets 60
jurneyman: calls 60
TheBigAceT: folds 
*** RIVER *** [8h 5s Qc 2c] [9c]
jurneyman: checks 
bluesteele: bets 60
jurneyman: calls 60
*** SHOW DOWN ***
bluesteele: shows [Qs Kc] (a pair of Queens)
jurneyman: shows [Kd 2d] (a pair of Deuces)
bluesteele collected 570 from  pot
*** SUMMARY ***
Total pot 570 | Rake 0 
Board [8h 5s Qc 2c 9c]
Seat 1: Starstealer folded before Flop (didn't bet)
Seat 2: bjackmurray folded before Flop (didn't bet)
Seat 3: NoleSAK folded before Flop (didn't bet)
Seat 4: awaone folded on the Flop
Seat 5: bluesteele showed [Qs Kc] and won (570) with a pair of Queens
Seat 6: catdaddy43 (button) folded before Flop (didn't bet)
Seat 7: jurneyman (small blind) showed [Kd 2d] and lost with a pair of Deuces
Seat 8: TheBigAceT (big blind) folded on the Turn
Seat 9: Perc60 folded before Flop (didn't bet)

*********** # 15 **************
PokerStars Game #136525796: Tournament #376033, Hold'em Limit - Level II (30/60) - 2003/10/05 - 00:16:06 (ET)
Table '376033 3' Seat #7 is the button
Seat 1: Starstealer (1970 in chips) 
Seat 2: bjackmurray (970 in chips) 
Seat 3: NoleSAK (1360 in chips) 
Seat 4: awaone (1650 in chips) 
Seat 5: bluesteele (2850 in chips) 
Seat 6: catdaddy43 (1440 in chips) is sitting out
Seat 7: jurneyman (540 in chips) 
Seat 8: TheBigAceT (1320 in chips) 
Seat 9: Perc60 (1810 in chips) 
TheBigAceT: posts small blind 15
Perc60: posts big blind 30
*** HOLE CARDS ***
Dealt to Starstealer [5s Jh]
Starstealer: folds 
bjackmurray: folds 
NoleSAK: folds 
awaone: calls 30
bluesteele: calls 30
catdaddy43: folds 
jurneyman: raises 30 to 60
TheBigAceT: calls 45
Perc60: calls 30
awaone: folds 
bluesteele: calls 30
*** FLOP *** [2c Th 3c]
TheBigAceT: checks 
Perc60: bets 30
bluesteele: calls 30
jurneyman: calls 30
TheBigAceT: calls 30
*** TURN *** [2c Th 3c] [2d]
TheBigAceT: checks 
Perc60: bets 60
bluesteele: folds 
jurneyman: folds 
TheBigAceT: calls 60
*** RIVER *** [2c Th 3c 2d] [5c]
TheBigAceT: checks 
Perc60: bets 60
TheBigAceT: calls 60
*** SHOW DOWN ***
Perc60: shows [3s Ah] (two pair, Threes and Deuces)
TheBigAceT: shows [Jd Tc] (two pair, Tens and Deuces)
TheBigAceT collected 630 from  pot
*** SUMMARY ***
Total pot 630 | Rake 0 
Board [2c Th 3c 2d 5c]
Seat 1: Starstealer folded before Flop (didn't bet)
Seat 2: bjackmurray folded before Flop (didn't bet)
Seat 3: NoleSAK folded before Flop (didn't bet)
Seat 4: awaone folded before Flop
Seat 5: bluesteele folded on the Turn
Seat 6: catdaddy43 folded before Flop (didn't bet)
Seat 7: jurneyman (button) folded on the Turn
Seat 8: TheBigAceT (small blind) showed [Jd Tc] and won (630) with two pair, Tens and Deuces
Seat 9: Perc60 (big blind) showed [3s Ah] and lost with two pair, Threes and Deuces

*********** # 16 **************
PokerStars Game #136527042: Tournament #376033, Hold'em Limit - Level II (30/60) - 2003/10/05 - 00:17:22 (ET)
Table '376033 3' Seat #8 is the button
Seat 1: Starstealer (1970 in chips) 
Seat 2: bjackmurray (970 in chips) 
Seat 3: NoleSAK (1360 in chips) 
Seat 4: awaone (1620 in chips) 
Seat 5: bluesteele (2760 in chips) 
Seat 6: catdaddy43 (1440 in chips) is sitting out
Seat 7: jurneyman (450 in chips) 
Seat 8: TheBigAceT (1740 in chips) 
Seat 9: Perc60 (1600 in chips) 
Perc60: posts small blind 15
Starstealer: posts big blind 30
*** HOLE CARDS ***
Dealt to Starstealer [9s Kh]
bjackmurray: calls 30
NoleSAK: folds 
awaone: folds 
bluesteele: calls 30
catdaddy43: folds 
jurneyman: raises 30 to 60
TheBigAceT: folds 
Perc60: calls 45
Starstealer: folds 
bjackmurray: calls 30
bluesteele: calls 30
*** FLOP *** [6c 2h 3h]
Perc60: bets 30
bjackmurray: calls 30
bluesteele: folds 
jurneyman: raises 30 to 60
Perc60: raises 30 to 90
bjackmurray: calls 60
jurneyman: raises 30 to 120
Betting is capped
Perc60: calls 30
bjackmurray: calls 30
*** TURN *** [6c 2h 3h] [7h]
Perc60: bets 60
bjackmurray: calls 60
jurneyman: calls 60
*** RIVER *** [6c 2h 3h 7h] [Js]
Perc60: checks 
bjackmurray: checks 
jurneyman: checks 
*** SHOW DOWN ***
Perc60: shows [Ac 6s] (a pair of Sixes)
bjackmurray: mucks hand 
jurneyman: shows [Th Tc] (a pair of Tens)
jurneyman collected 810 from  pot
*** SUMMARY ***
Total pot 810 | Rake 0 
Board [6c 2h 3h 7h Js]
Seat 1: Starstealer (big blind) folded before Flop
Seat 2: bjackmurray mucked [Kc Ad] - high card Ace
Seat 3: NoleSAK folded before Flop (didn't bet)
Seat 4: awaone folded before Flop (didn't bet)
Seat 5: bluesteele folded on the Flop
Seat 6: catdaddy43 folded before Flop (didn't bet)
Seat 7: jurneyman showed [Th Tc] and won (810) with a pair of Tens
Seat 8: TheBigAceT (button) folded before Flop (didn't bet)
Seat 9: Perc60 (small blind) showed [Ac 6s] and lost with a pair of Sixes

*********** # 17 **************
PokerStars Game #136528342: Tournament #376033, Hold'em Limit - Level II (30/60) - 2003/10/05 - 00:18:44 (ET)
Table '376033 3' Seat #9 is the button
Seat 1: Starstealer (1940 in chips) 
Seat 2: bjackmurray (730 in chips) 
Seat 3: NoleSAK (1360 in chips) 
Seat 4: awaone (1620 in chips) 
Seat 5: bluesteele (2700 in chips) 
Seat 6: catdaddy43 (1440 in chips) is sitting out
Seat 7: jurneyman (1020 in chips) 
Seat 8: TheBigAceT (1740 in chips) 
Seat 9: Perc60 (1360 in chips) 
Starstealer: posts small blind 15
bjackmurray: posts big blind 30
*** HOLE CARDS ***
Dealt to Starstealer [4s 7h]
NoleSAK: calls 30
awaone: calls 30
bluesteele: folds 
catdaddy43: folds 
jurneyman: calls 30
TheBigAceT: folds 
Perc60: calls 30
Starstealer: folds 
bjackmurray: checks 
*** FLOP *** [2s 8s 9c]
bjackmurray: checks 
NoleSAK: bets 30
awaone: calls 30
jurneyman: calls 30
Perc60: raises 30 to 60
bjackmurray: calls 60
NoleSAK: calls 30
awaone: folds 
jurneyman: calls 30
*** TURN *** [2s 8s 9c] [8d]
bjackmurray: checks 
NoleSAK: checks 
jurneyman: checks 
Perc60: bets 60
bjackmurray: calls 60
NoleSAK: calls 60
jurneyman: calls 60
*** RIVER *** [2s 8s 9c 8d] [Qh]
bjackmurray: bets 60
NoleSAK: folds 
jurneyman: calls 60
Perc60: raises 60 to 120
bjackmurray: calls 60
jurneyman: folds 
*** SHOW DOWN ***
Perc60: shows [Qs 8c] (a full house, Eights full of Queens)
bjackmurray: mucks hand 
Perc60 collected 975 from  pot
*** SUMMARY ***
Total pot 975 | Rake 0 
Board [2s 8s 9c 8d Qh]
Seat 1: Starstealer (small blind) folded before Flop
Seat 2: bjackmurray (big blind) mucked [Qc Jh] - two pair, Queens and Eights
Seat 3: NoleSAK folded on the River
Seat 4: awaone folded on the Flop
Seat 5: bluesteele folded before Flop (didn't bet)
Seat 6: catdaddy43 folded before Flop (didn't bet)
Seat 7: jurneyman folded on the River
Seat 8: TheBigAceT folded before Flop (didn't bet)
Seat 9: Perc60 (button) showed [Qs 8c] and won (975) with a full house, Eights full of Queens

*********** # 18 **************
PokerStars Game #136530055: Tournament #376033, Hold'em Limit - Level II (30/60) - 2003/10/05 - 00:20:28 (ET)
Table '376033 3' Seat #1 is the button
Seat 1: Starstealer (1925 in chips) 
Seat 2: bjackmurray (460 in chips) 
Seat 3: NoleSAK (1210 in chips) 
Seat 4: awaone (1560 in chips) 
Seat 5: bluesteele (2700 in chips) 
Seat 6: catdaddy43 (1440 in chips) is sitting out
Seat 7: jurneyman (810 in chips) 
Seat 8: TheBigAceT (1740 in chips) 
Seat 9: Perc60 (2065 in chips) 
bjackmurray: posts small blind 15
NoleSAK: posts big blind 30
*** HOLE CARDS ***
Dealt to Starstealer [5d 6c]
awaone: folds 
bluesteele: calls 30
catdaddy43: folds 
jurneyman: folds 
TheBigAceT: folds 
Perc60: folds 
Starstealer: folds 
bjackmurray: raises 30 to 60
NoleSAK: calls 30
bluesteele: calls 30
*** FLOP *** [7s Kd 2h]
bjackmurray: bets 30
NoleSAK: folds 
bluesteele: folds 
bjackmurray collected 180 from  pot
bjackmurray: doesn't show hand 
*** SUMMARY ***
Total pot 180 | Rake 0 
Board [7s Kd 2h]
Seat 1: Starstealer (button) folded before Flop (didn't bet)
Seat 2: bjackmurray (small blind) collected (180)
Seat 3: NoleSAK (big blind) folded on the Flop
Seat 4: awaone folded before Flop (didn't bet)
Seat 5: bluesteele folded on the Flop
Seat 6: catdaddy43 folded before Flop (didn't bet)
Seat 7: jurneyman folded before Flop (didn't bet)
Seat 8: TheBigAceT folded before Flop (didn't bet)
Seat 9: Perc60 folded before Flop (didn't bet)

*********** # 19 **************
PokerStars Game #136530711: Tournament #376033, Hold'em Limit - Level II (30/60) - 2003/10/05 - 00:21:07 (ET)
Table '376033 3' Seat #2 is the button
Seat 1: Starstealer (1925 in chips) 
Seat 2: bjackmurray (580 in chips) 
Seat 3: NoleSAK (1150 in chips) 
Seat 4: awaone (1560 in chips) 
Seat 5: bluesteele (2640 in chips) 
Seat 6: catdaddy43 (1440 in chips) is sitting out
Seat 7: jurneyman (810 in chips) 
Seat 8: TheBigAceT (1740 in chips) 
Seat 9: Perc60 (2065 in chips) 
NoleSAK: posts small blind 15
awaone: posts big blind 30
*** HOLE CARDS ***
Dealt to Starstealer [Qs Th]
bluesteele: calls 30
catdaddy43: folds 
jurneyman: calls 30
TheBigAceT: folds 
Perc60: calls 30
Starstealer: folds 
bjackmurray: folds 
NoleSAK: raises 30 to 60
awaone: calls 30
bluesteele: calls 30
jurneyman: calls 30
Perc60: calls 30
*** FLOP *** [4d 3d 9s]
NoleSAK: bets 30
awaone: folds 
bluesteele: calls 30
jurneyman: calls 30
Perc60: calls 30
*** TURN *** [4d 3d 9s] [3s]
NoleSAK: checks 
bluesteele: checks 
jurneyman: bets 60
Perc60: folds 
NoleSAK: folds 
bluesteele: calls 60
*** RIVER *** [4d 3d 9s 3s] [5c]
bluesteele: checks 
jurneyman: bets 60
bluesteele: calls 60
*** SHOW DOWN ***
jurneyman: shows [Kh 6h] (a pair of Threes)
bluesteele: shows [9h 8h] (two pair, Nines and Threes)
bluesteele collected 660 from  pot
*** SUMMARY ***
Total pot 660 | Rake 0 
Board [4d 3d 9s 3s 5c]
Seat 1: Starstealer folded before Flop (didn't bet)
Seat 2: bjackmurray (button) folded before Flop (didn't bet)
Seat 3: NoleSAK (small blind) folded on the Turn
Seat 4: awaone (big blind) folded on the Flop
Seat 5: bluesteele showed [9h 8h] and won (660) with two pair, Nines and Threes
Seat 6: catdaddy43 folded before Flop (didn't bet)
Seat 7: jurneyman showed [Kh 6h] and lost with a pair of Threes
Seat 8: TheBigAceT folded before Flop (didn't bet)
Seat 9: Perc60 folded on the Turn

*********** # 20 **************
PokerStars Game #136531873: Tournament #376033, Hold'em Limit - Level II (30/60) - 2003/10/05 - 00:22:21 (ET)
Table '376033 3' Seat #3 is the button
Seat 1: Starstealer (1925 in chips) 
Seat 2: bjackmurray (580 in chips) 
Seat 3: NoleSAK (1060 in chips) 
Seat 4: awaone (1500 in chips) 
Seat 5: bluesteele (3090 in chips) 
Seat 6: catdaddy43 (1440 in chips) is sitting out
Seat 7: jurneyman (600 in chips) 
Seat 8: TheBigAceT (1740 in chips) 
Seat 9: Perc60 (1975 in chips) 
awaone: posts small blind 15
bluesteele: posts big blind 30
*** HOLE CARDS ***
Dealt to Starstealer [5d 5c]
catdaddy43: folds 
jurneyman: calls 30
TheBigAceT: folds 
Perc60: calls 30
Starstealer: raises 30 to 60
bjackmurray: calls 60
NoleSAK: folds 
awaone: folds 
bluesteele: calls 30
jurneyman: calls 30
Perc60: raises 30 to 90
Starstealer: calls 30
bjackmurray: calls 30
bluesteele: calls 30
jurneyman: calls 30
*** FLOP *** [Tc Jc 4h]
bluesteele: checks 
jurneyman: checks 
Perc60: bets 30
Starstealer: calls 30
bjackmurray: calls 30
bluesteele: calls 30
jurneyman: folds 
*** TURN *** [Tc Jc 4h] [Ks]
bluesteele: checks 
Perc60: bets 60
Starstealer: folds 
bjackmurray: calls 60
bluesteele: calls 60
*** RIVER *** [Tc Jc 4h Ks] [Js]
bluesteele: checks 
Perc60: bets 60
bjackmurray: folds 
bluesteele: calls 60
*** SHOW DOWN ***
Perc60: shows [2d Ad] (a pair of Jacks)
bluesteele: shows [Qc 4c] (two pair, Jacks and Fours)
bluesteele collected 885 from  pot
*** SUMMARY ***
Total pot 885 | Rake 0 
Board [Tc Jc 4h Ks Js]
Seat 1: Starstealer folded on the Turn
Seat 2: bjackmurray folded on the River
Seat 3: NoleSAK (button) folded before Flop (didn't bet)
Seat 4: awaone (small blind) folded before Flop
Seat 5: bluesteele (big blind) showed [Qc 4c] and won (885) with two pair, Jacks and Fours
Seat 6: catdaddy43 folded before Flop (didn't bet)
Seat 7: jurneyman folded on the Flop
Seat 8: TheBigAceT folded before Flop (didn't bet)
Seat 9: Perc60 showed [2d Ad] and lost with a pair of Jacks

*********** # 21 **************
PokerStars Game #136533381: Tournament #376033, Hold'em Limit - Level II (30/60) - 2003/10/05 - 00:23:53 (ET)
Table '376033 3' Seat #4 is the button
Seat 1: Starstealer (1805 in chips) 
Seat 2: bjackmurray (400 in chips) 
Seat 3: NoleSAK (1060 in chips) 
Seat 4: awaone (1485 in chips) 
Seat 5: bluesteele (3735 in chips) 
Seat 6: catdaddy43 (1440 in chips) is sitting out
Seat 7: jurneyman (510 in chips) 
Seat 8: TheBigAceT (1740 in chips) 
Seat 9: Perc60 (1735 in chips) 
bluesteele: posts small blind 15
catdaddy43: posts big blind 30
*** HOLE CARDS ***
Dealt to Starstealer [2h 2c]
jurneyman: calls 30
TheBigAceT: raises 30 to 60
Perc60: folds 
Starstealer: calls 60
bjackmurray: folds 
NoleSAK: calls 60
awaone: folds 
bluesteele: calls 45
catdaddy43: folds 
jurneyman: calls 30
*** FLOP *** [Qd 9s 3h]
bluesteele: checks 
jurneyman: bets 30
TheBigAceT: calls 30
Starstealer: folds 
NoleSAK: folds 
bluesteele: calls 30
*** TURN *** [Qd 9s 3h] [6c]
bluesteele: checks 
jurneyman: bets 60
TheBigAceT: folds 
bluesteele: calls 60
*** RIVER *** [Qd 9s 3h 6c] [8c]
bluesteele: checks 
jurneyman: checks 
*** SHOW DOWN ***
bluesteele: shows [4d 3d] (a pair of Threes)
jurneyman: shows [4c 3c] (a pair of Threes)
bluesteele collected 270 from  pot
jurneyman collected 270 from  pot
*** SUMMARY ***
Total pot 540 | Rake 0 
Board [Qd 9s 3h 6c 8c]
Seat 1: Starstealer folded on the Flop
Seat 2: bjackmurray folded before Flop (didn't bet)
Seat 3: NoleSAK folded on the Flop
Seat 4: awaone (button) folded before Flop (didn't bet)
Seat 5: bluesteele (small blind) showed [4d 3d] and won (270) with a pair of Threes
Seat 6: catdaddy43 (big blind) folded before Flop
Seat 7: jurneyman showed [4c 3c] and won (270) with a pair of Threes
Seat 8: TheBigAceT folded on the Turn
Seat 9: Perc60 folded before Flop (didn't bet)

*********** # 22 **************
PokerStars Game #136534508: Tournament #376033, Hold'em Limit - Level II (30/60) - 2003/10/05 - 00:25:02 (ET)
Table '376033 3' Seat #5 is the button
Seat 1: Starstealer (1745 in chips) 
Seat 2: bjackmurray (400 in chips) 
Seat 3: NoleSAK (1000 in chips) 
Seat 4: awaone (1485 in chips) 
Seat 5: bluesteele (3855 in chips) 
Seat 6: catdaddy43 (1410 in chips) is sitting out
Seat 7: jurneyman (630 in chips) 
Seat 8: TheBigAceT (1650 in chips) 
Seat 9: Perc60 (1735 in chips) 
catdaddy43: posts small blind 15
jurneyman: posts big blind 30
*** HOLE CARDS ***
Dealt to Starstealer [Qd 2c]
TheBigAceT: folds 
Perc60: folds 
Starstealer: folds 
bjackmurray: calls 30
NoleSAK: raises 30 to 60
awaone: folds 
bluesteele: calls 60
catdaddy43: folds 
jurneyman: raises 30 to 90
bjackmurray: calls 60
NoleSAK: raises 30 to 120
Betting is capped
bluesteele: calls 60
jurneyman: calls 30
bjackmurray: calls 30
*** FLOP *** [Tc Ts As]
jurneyman: bets 30
bjackmurray: raises 30 to 60
NoleSAK: raises 30 to 90
bluesteele: folds 
jurneyman: calls 60
bjackmurray: raises 30 to 120
Betting is capped
NoleSAK: calls 30
jurneyman: calls 30
*** TURN *** [Tc Ts As] [3d]
jurneyman: checks 
bjackmurray: bets 60
NoleSAK: calls 60
jurneyman: calls 60
*** RIVER *** [Tc Ts As 3d] [5c]
jurneyman: checks 
bjackmurray: bets 60
NoleSAK: calls 60
jurneyman: folds 
*** SHOW DOWN ***
bjackmurray: shows [Td Js] (three of a kind, Tens)
NoleSAK: mucks hand 
bjackmurray collected 1155 from  pot
*** SUMMARY ***
Total pot 1155 | Rake 0 
Board [Tc Ts As 3d 5c]
Seat 1: Starstealer folded before Flop (didn't bet)
Seat 2: bjackmurray showed [Td Js] and won (1155) with three of a kind, Tens
Seat 3: NoleSAK mucked [Qc Ah] - two pair, Aces and Tens
Seat 4: awaone folded before Flop (didn't bet)
Seat 5: bluesteele (button) folded on the Flop
Seat 6: catdaddy43 (small blind) folded before Flop
Seat 7: jurneyman (big blind) folded on the River
Seat 8: TheBigAceT folded before Flop (didn't bet)
Seat 9: Perc60 folded before Flop (didn't bet)

*********** # 23 **************
PokerStars Game #136535665: Tournament #376033, Hold'em Limit - Level II (30/60) - 2003/10/05 - 00:26:16 (ET)
Table '376033 3' Seat #6 is the button
Seat 1: Starstealer (1745 in chips) 
Seat 2: bjackmurray (1195 in chips) 
Seat 3: NoleSAK (640 in chips) 
Seat 4: awaone (1485 in chips) 
Seat 5: bluesteele (3735 in chips) 
Seat 6: catdaddy43 (1395 in chips) is sitting out
Seat 7: jurneyman (330 in chips) 
Seat 8: TheBigAceT (1650 in chips) 
Seat 9: Perc60 (1735 in chips) 
jurneyman: posts small blind 15
TheBigAceT: posts big blind 30
*** HOLE CARDS ***
Dealt to Starstealer [Th Kh]
Perc60: calls 30
Starstealer: folds 
bjackmurray: folds 
NoleSAK: raises 30 to 60
awaone: folds 
bluesteele: folds 
catdaddy43: folds 
jurneyman: calls 45
TheBigAceT: calls 30
Perc60: calls 30
*** FLOP *** [Kd 3h 5h]
jurneyman: checks 
TheBigAceT: checks 
Perc60: checks 
NoleSAK: checks 
*** TURN *** [Kd 3h 5h] [4s]
jurneyman: bets 60
TheBigAceT: folds 
Perc60: raises 60 to 120
NoleSAK: folds 
jurneyman: calls 60
*** RIVER *** [Kd 3h 5h 4s] [2d]
catdaddy43 is connected 
catdaddy43 has returned
jurneyman: bets 60
Perc60: calls 60
*** SHOW DOWN ***
jurneyman: shows [Jd 7s] (high card King)
Perc60: shows [3d 4d] (two pair, Fours and Threes)
Perc60 collected 600 from  pot
*** SUMMARY ***
Total pot 600 | Rake 0 
Board [Kd 3h 5h 4s 2d]
Seat 1: Starstealer folded before Flop (didn't bet)
Seat 2: bjackmurray folded before Flop (didn't bet)
Seat 3: NoleSAK folded on the Turn
Seat 4: awaone folded before Flop (didn't bet)
Seat 5: bluesteele folded before Flop (didn't bet)
Seat 6: catdaddy43 (button) folded before Flop (didn't bet)
Seat 7: jurneyman (small blind) showed [Jd 7s] and lost with high card King
Seat 8: TheBigAceT (big blind) folded on the Turn
Seat 9: Perc60 showed [3d 4d] and won (600) with two pair, Fours and Threes

*********** # 24 **************
PokerStars Game #136536654: Tournament #376033, Hold'em Limit - Level II (30/60) - 2003/10/05 - 00:27:20 (ET)
Table '376033 3' Seat #7 is the button
Seat 1: Starstealer (1745 in chips) 
Seat 2: bjackmurray (1195 in chips) 
Seat 3: NoleSAK (580 in chips) 
Seat 4: awaone (1485 in chips) 
Seat 5: bluesteele (3735 in chips) 
Seat 6: catdaddy43 (1395 in chips) 
Seat 7: jurneyman (90 in chips) 
Seat 8: TheBigAceT (1590 in chips) 
Seat 9: Perc60 (2095 in chips) 
TheBigAceT: posts small blind 15
Perc60: posts big blind 30
*** HOLE CARDS ***
Dealt to Starstealer [Qc Qd]
Starstealer: raises 30 to 60
bjackmurray: folds 
NoleSAK: folds 
awaone: calls 60
bluesteele: folds 
catdaddy43: folds 
jurneyman: folds 
TheBigAceT: folds 
Perc60: folds 
*** FLOP *** [Ad 8d 9h]
Starstealer: bets 30
awaone: calls 30
*** TURN *** [Ad 8d 9h] [7h]
Starstealer: bets 60
awaone: calls 60
*** RIVER *** [Ad 8d 9h 7h] [Kc]
Starstealer: bets 60
awaone: calls 60
*** SHOW DOWN ***
Starstealer: shows [Qc Qd] (a pair of Queens)
awaone: shows [As Jh] (a pair of Aces)
awaone collected 465 from  pot
*** SUMMARY ***
Total pot 465 | Rake 0 
Board [Ad 8d 9h 7h Kc]
Seat 1: Starstealer showed [Qc Qd] and lost with a pair of Queens
Seat 2: bjackmurray folded before Flop (didn't bet)
Seat 3: NoleSAK folded before Flop (didn't bet)
Seat 4: awaone showed [As Jh] and won (465) with a pair of Aces
Seat 5: bluesteele folded before Flop (didn't bet)
Seat 6: catdaddy43 folded before Flop (didn't bet)
Seat 7: jurneyman (button) folded before Flop (didn't bet)
Seat 8: TheBigAceT (small blind) folded before Flop
Seat 9: Perc60 (big blind) folded before Flop

*********** # 25 **************
PokerStars Game #136537751: Tournament #376033, Hold'em Limit - Level II (30/60) - 2003/10/05 - 00:28:32 (ET)
Table '376033 3' Seat #8 is the button
Seat 1: Starstealer (1535 in chips) 
Seat 2: bjackmurray (1195 in chips) 
Seat 3: NoleSAK (580 in chips) 
Seat 4: awaone (1740 in chips) 
Seat 5: bluesteele (3735 in chips) 
Seat 6: catdaddy43 (1395 in chips) 
Seat 7: jurneyman (90 in chips) 
Seat 8: TheBigAceT (1575 in chips) 
Seat 9: Perc60 (2065 in chips) 
Perc60: posts small blind 15
Starstealer: posts big blind 30
*** HOLE CARDS ***
Dealt to Starstealer [6d 6h]
bjackmurray: calls 30
NoleSAK: calls 30
awaone: calls 30
bluesteele: folds 
catdaddy43: calls 30
jurneyman: calls 30
TheBigAceT: calls 30
Perc60: folds 
Starstealer: checks 
*** FLOP *** [9c 3d 9d]
Starstealer: checks 
bjackmurray: checks 
NoleSAK: checks 
awaone: bets 30
catdaddy43: folds 
jurneyman: raises 30 to 60 and is all-in
TheBigAceT: folds 
Starstealer: calls 60
bjackmurray: folds 
NoleSAK: folds 
awaone: calls 30
*** TURN *** [9c 3d 9d] [3h]
Starstealer: checks 
awaone: bets 60
Starstealer: calls 60
*** RIVER *** [9c 3d 9d 3h] [Ad]
Starstealer: checks 
awaone: bets 60
Starstealer: calls 60
*** SHOW DOWN ***
awaone: shows [9s 8s] (a full house, Nines full of Threes)
Starstealer: mucks hand 
awaone collected 240 from side pot
NoleSAK said, "vnh"
jurneyman: shows [3s Jh] (a full house, Threes full of Nines)
awaone collected 405 from main pot
*** SUMMARY ***
Total pot 645 Main pot 405. Side pot 240. | Rake 0 
Board [9c 3d 9d 3h Ad]
Seat 1: Starstealer (big blind) mucked [6d 6h] - two pair, Nines and Sixes
Seat 2: bjackmurray folded on the Flop
Seat 3: NoleSAK folded on the Flop
Seat 4: awaone showed [9s 8s] and won (645) with a full house, Nines full of Threes
Seat 5: bluesteele folded before Flop (didn't bet)
Seat 6: catdaddy43 folded on the Flop
Seat 7: jurneyman showed [3s Jh] and lost with a full house, Threes full of Nines
Seat 8: TheBigAceT (button) folded on the Flop
Seat 9: Perc60 (small blind) folded before Flop

*********** # 26 **************
PokerStars Game #136539299: Tournament #376033, Hold'em Limit - Level III (50/100) - 2003/10/05 - 00:30:11 (ET)
Table '376033 3' Seat #9 is the button
Seat 1: Starstealer (1325 in chips) 
Seat 2: bjackmurray (1165 in chips) 
Seat 3: NoleSAK (550 in chips) 
Seat 4: awaone (2175 in chips) 
Seat 5: bluesteele (3735 in chips) 
Seat 6: catdaddy43 (1365 in chips) 
Seat 8: TheBigAceT (1545 in chips) 
Seat 9: Perc60 (2050 in chips) 
Starstealer: posts small blind 25
bjackmurray: posts big blind 50
*** HOLE CARDS ***
Dealt to Starstealer [5d 8h]
NoleSAK: calls 50
awaone: calls 50
bluesteele: folds 
catdaddy43: folds 
TheBigAceT: folds 
Perc60: raises 50 to 100
Starstealer: folds 
bjackmurray: calls 50
NoleSAK: calls 50
awaone: folds 
*** FLOP *** [Ac 5h 3h]
bjackmurray: checks 
NoleSAK: checks 
Perc60: bets 50
bjackmurray: calls 50
NoleSAK: folds 
*** TURN *** [Ac 5h 3h] [2c]
bjackmurray: bets 100
Perc60: raises 100 to 200
bjackmurray: calls 100
*** RIVER *** [Ac 5h 3h 2c] [Kh]
bjackmurray: bets 100
Perc60: calls 100
*** SHOW DOWN ***
bjackmurray: shows [2s 2d] (three of a kind, Deuces)
Perc60: mucks hand 
bjackmurray collected 1075 from  pot
*** SUMMARY ***
Total pot 1075 | Rake 0 
Board [Ac 5h 3h 2c Kh]
Seat 1: Starstealer (small blind) folded before Flop
Seat 2: bjackmurray (big blind) showed [2s 2d] and won (1075) with three of a kind, Deuces
Seat 3: NoleSAK folded on the Flop
Seat 4: awaone folded before Flop
Seat 5: bluesteele folded before Flop (didn't bet)
Seat 6: catdaddy43 folded before Flop (didn't bet)
Seat 8: TheBigAceT folded before Flop (didn't bet)
Seat 9: Perc60 (button) mucked [Ad 8c] - a pair of Aces

*********** # 27 **************
PokerStars Game #136540149: Tournament #376033, Hold'em Limit - Level III (50/100) - 2003/10/05 - 00:31:11 (ET)
Table '376033 3' Seat #1 is the button
Seat 1: Starstealer (1300 in chips) 
Seat 2: bjackmurray (1790 in chips) 
Seat 3: NoleSAK (450 in chips) 
Seat 4: awaone (2125 in chips) 
Seat 5: bluesteele (3735 in chips) 
Seat 6: catdaddy43 (1365 in chips) 
Seat 8: TheBigAceT (1545 in chips) 
Seat 9: Perc60 (1600 in chips) 
bjackmurray: posts small blind 25
NoleSAK: posts big blind 50
*** HOLE CARDS ***
Dealt to Starstealer [6d 3c]
awaone has timed out
awaone: folds 
awaone is sitting out
awaone has returned
bluesteele: calls 50
catdaddy43: folds 
TheBigAceT: folds 
Perc60: raises 50 to 100
Starstealer: folds 
bjackmurray: folds 
NoleSAK: raises 50 to 150
bluesteele: calls 100
Perc60: raises 50 to 200
Betting is capped
NoleSAK: calls 50
bluesteele: calls 50
*** FLOP *** [5h Tc 6c]
NoleSAK: checks 
bluesteele: bets 50
Perc60: raises 50 to 100
NoleSAK: calls 100
bluesteele: calls 50
*** TURN *** [5h Tc 6c] [Th]
NoleSAK: checks 
bluesteele: bets 100
Perc60: raises 100 to 200
NoleSAK: folds 
bluesteele: calls 100
*** RIVER *** [5h Tc 6c Th] [8d]
bluesteele: checks 
Perc60: bets 100
bluesteele: calls 100
*** SHOW DOWN ***
Perc60: shows [Js Qs] (a pair of Tens)
bluesteele: shows [9d 5d] (two pair, Tens and Fives)
bluesteele collected 1525 from  pot
*** SUMMARY ***
Total pot 1525 | Rake 0 
Board [5h Tc 6c Th 8d]
Seat 1: Starstealer (button) folded before Flop (didn't bet)
Seat 2: bjackmurray (small blind) folded before Flop
Seat 3: NoleSAK (big blind) folded on the Turn
Seat 4: awaone folded before Flop (didn't bet)
Seat 5: bluesteele showed [9d 5d] and won (1525) with two pair, Tens and Fives
Seat 6: catdaddy43 folded before Flop (didn't bet)
Seat 8: TheBigAceT folded before Flop (didn't bet)
Seat 9: Perc60 showed [Js Qs] and lost with a pair of Tens

*********** # 28 **************
PokerStars Game #136541431: Tournament #376033, Hold'em Limit - Level III (50/100) - 2003/10/05 - 00:32:41 (ET)
Table '376033 3' Seat #2 is the button
Seat 1: Starstealer (1300 in chips) 
Seat 2: bjackmurray (1765 in chips) 
Seat 3: NoleSAK (150 in chips) 
Seat 4: awaone (2125 in chips) 
Seat 5: bluesteele (4660 in chips) 
Seat 6: catdaddy43 (1365 in chips) 
Seat 7: brens420 (1340 in chips) is sitting out
Seat 8: TheBigAceT (1545 in chips) 
Seat 9: Perc60 (1000 in chips) 
NoleSAK: posts small blind 25
awaone: posts big blind 50
*** HOLE CARDS ***
Dealt to Starstealer [6c Jd]
bluesteele: calls 50
catdaddy43: calls 50
brens420: folds 
TheBigAceT: folds 
Perc60: raises 50 to 100
Starstealer: folds 
bjackmurray: folds 
NoleSAK: folds 
awaone: folds 
bluesteele: calls 50
catdaddy43: calls 50
*** FLOP *** [9d Tc Qh]
bluesteele: bets 50
catdaddy43: raises 50 to 100
Perc60: folds 
bluesteele: calls 50
*** TURN *** [9d Tc Qh] [5h]
bluesteele: checks 
catdaddy43: bets 100
bluesteele: calls 100
*** RIVER *** [9d Tc Qh 5h] [4s]
bluesteele: checks 
catdaddy43: bets 100
bluesteele: calls 100
*** SHOW DOWN ***
catdaddy43: shows [Jc 4c] (a pair of Fours)
bluesteele: shows [Ts Jh] (a pair of Tens)
bluesteele collected 975 from  pot
*** SUMMARY ***
Total pot 975 | Rake 0 
Board [9d Tc Qh 5h 4s]
Seat 1: Starstealer folded before Flop (didn't bet)
Seat 2: bjackmurray (button) folded before Flop (didn't bet)
Seat 3: NoleSAK (small blind) folded before Flop
Seat 4: awaone (big blind) folded before Flop
Seat 5: bluesteele showed [Ts Jh] and won (975) with a pair of Tens
Seat 6: catdaddy43 showed [Jc 4c] and lost with a pair of Fours
Seat 7: brens420 folded before Flop (didn't bet)
Seat 8: TheBigAceT folded before Flop (didn't bet)
Seat 9: Perc60 folded on the Flop

*********** # 29 **************
PokerStars Game #136542802: Tournament #376033, Hold'em Limit - Level III (50/100) - 2003/10/05 - 00:34:15 (ET)
Table '376033 3' Seat #3 is the button
Seat 1: Starstealer (1300 in chips) 
Seat 2: bjackmurray (1765 in chips) 
Seat 3: NoleSAK (125 in chips) 
Seat 4: awaone (2075 in chips) 
Seat 5: bluesteele (5235 in chips) 
Seat 6: catdaddy43 (965 in chips) 
Seat 7: brens420 (1340 in chips) is sitting out
Seat 8: TheBigAceT (1545 in chips) 
Seat 9: Perc60 (900 in chips) 
awaone: posts small blind 25
bluesteele: posts big blind 50
*** HOLE CARDS ***
Dealt to Starstealer [9d 6h]
catdaddy43: raises 50 to 100
brens420: folds 
TheBigAceT: folds 
Perc60: calls 100
Starstealer: folds 
bjackmurray: folds 
NoleSAK: folds 
awaone: calls 75
bluesteele: calls 50
*** FLOP *** [8d Jd 4c]
awaone: checks 
bluesteele: bets 50
catdaddy43: raises 50 to 100
Perc60: folds 
awaone: folds 
bluesteele: calls 50
*** TURN *** [8d Jd 4c] [Tc]
bluesteele: checks 
catdaddy43: bets 100
bluesteele: calls 100
*** RIVER *** [8d Jd 4c Tc] [4s]
bluesteele: checks 
catdaddy43: bets 100
bluesteele: calls 100
*** SHOW DOWN ***
catdaddy43: shows [Qh Js] (two pair, Jacks and Fours)
bluesteele: mucks hand 
catdaddy43 collected 1000 from  pot
*** SUMMARY ***
Total pot 1000 | Rake 0 
Board [8d Jd 4c Tc 4s]
Seat 1: Starstealer folded before Flop (didn't bet)
Seat 2: bjackmurray folded before Flop (didn't bet)
Seat 3: NoleSAK (button) folded before Flop (didn't bet)
Seat 4: awaone (small blind) folded on the Flop
Seat 5: bluesteele (big blind) mucked [7h 8s] - two pair, Eights and Fours
Seat 6: catdaddy43 showed [Qh Js] and won (1000) with two pair, Jacks and Fours
Seat 7: brens420 folded before Flop (didn't bet)
Seat 8: TheBigAceT folded before Flop (didn't bet)
Seat 9: Perc60 folded on the Flop

*********** # 30 **************
PokerStars Game #136543839: Tournament #376033, Hold'em Limit - Level III (50/100) - 2003/10/05 - 00:35:29 (ET)
Table '376033 3' Seat #4 is the button
Seat 1: Starstealer (1300 in chips) 
Seat 2: bjackmurray (1765 in chips) 
Seat 3: NoleSAK (125 in chips) 
Seat 4: awaone (1975 in chips) 
Seat 5: bluesteele (4835 in chips) 
Seat 6: catdaddy43 (1565 in chips) 
Seat 7: brens420 (1340 in chips) is sitting out
Seat 8: TheBigAceT (1545 in chips) 
Seat 9: Perc60 (800 in chips) 
bluesteele: posts small blind 25
catdaddy43: posts big blind 50
*** HOLE CARDS ***
Dealt to Starstealer [3c 8d]
brens420: folds 
TheBigAceT: folds 
Perc60: folds 
Starstealer: folds 
bjackmurray: folds 
NoleSAK: folds 
awaone: calls 50
bluesteele: calls 25
catdaddy43: raises 50 to 100
awaone: folds 
bluesteele: calls 50
*** FLOP *** [5d 7h Jh]
bluesteele: checks 
catdaddy43: checks 
*** TURN *** [5d 7h Jh] [Kc]
bluesteele: bets 100
catdaddy43: raises 100 to 200
bluesteele: calls 100
*** RIVER *** [5d 7h Jh Kc] [Qh]
bluesteele: checks 
catdaddy43: checks 
*** SHOW DOWN ***
bluesteele: shows [Qs 7d] (two pair, Queens and Sevens)
catdaddy43: mucks hand 
bluesteele collected 650 from  pot
*** SUMMARY ***
Total pot 650 | Rake 0 
Board [5d 7h Jh Kc Qh]
Seat 1: Starstealer folded before Flop (didn't bet)
Seat 2: bjackmurray folded before Flop (didn't bet)
Seat 3: NoleSAK folded before Flop (didn't bet)
Seat 4: awaone (button) folded before Flop
Seat 5: bluesteele (small blind) showed [Qs 7d] and won (650) with two pair, Queens and Sevens
Seat 6: catdaddy43 (big blind) mucked [Ks Ts] - a pair of Kings
Seat 7: brens420 folded before Flop (didn't bet)
Seat 8: TheBigAceT folded before Flop (didn't bet)
Seat 9: Perc60 folded before Flop (didn't bet)

*********** # 31 **************
PokerStars Game #136544867: Tournament #376033, Hold'em Limit - Level III (50/100) - 2003/10/05 - 00:36:42 (ET)
Table '376033 3' Seat #5 is the button
Seat 1: Starstealer (1300 in chips) 
Seat 2: bjackmurray (1765 in chips) 
Seat 3: NoleSAK (125 in chips) 
Seat 4: awaone (1925 in chips) 
Seat 5: bluesteele (5185 in chips) 
Seat 6: catdaddy43 (1265 in chips) 
Seat 7: brens420 (1340 in chips) is sitting out
Seat 8: TheBigAceT (1545 in chips) 
Seat 9: Perc60 (800 in chips) 
catdaddy43: posts small blind 25
brens420: posts big blind 50
*** HOLE CARDS ***
Dealt to Starstealer [Th Jd]
TheBigAceT: folds 
Perc60: folds 
Starstealer: folds 
bjackmurray: folds 
NoleSAK: calls 50
awaone: calls 50
bluesteele: calls 50
catdaddy43: calls 25
brens420: folds 
*** FLOP *** [4d 6s Ts]
catdaddy43: bets 50
NoleSAK: raises 25 to 75 and is all-in
awaone: folds 
bluesteele: calls 75
catdaddy43: calls 25
*** TURN *** [4d 6s Ts] [Ah]
catdaddy43: checks 
bluesteele: checks 
*** RIVER *** [4d 6s Ts Ah] [Qs]
catdaddy43: checks 
bluesteele: checks 
*** SHOW DOWN ***
catdaddy43: shows [9h Td] (a pair of Tens)
NoleSAK: shows [Ad 4h] (two pair, Aces and Fours)
bluesteele: mucks hand 
NoleSAK collected 475 from  pot
*** SUMMARY ***
Total pot 475 | Rake 0 
Board [4d 6s Ts Ah Qs]
Seat 1: Starstealer folded before Flop (didn't bet)
Seat 2: bjackmurray folded before Flop (didn't bet)
Seat 3: NoleSAK showed [Ad 4h] and won (475) with two pair, Aces and Fours
Seat 4: awaone folded on the Flop
Seat 5: bluesteele (button) mucked [Jc 7h] - high card Ace
Seat 6: catdaddy43 (small blind) showed [9h Td] and lost with a pair of Tens
Seat 7: brens420 (big blind) folded before Flop
Seat 8: TheBigAceT folded before Flop (didn't bet)
Seat 9: Perc60 folded before Flop (didn't bet)

*********** # 32 **************
PokerStars Game #136546016: Tournament #376033, Hold'em Limit - Level III (50/100) - 2003/10/05 - 00:37:59 (ET)
Table '376033 3' Seat #6 is the button
Seat 1: Starstealer (1300 in chips) 
Seat 2: bjackmurray (1765 in chips) 
Seat 3: NoleSAK (475 in chips) 
Seat 4: awaone (1875 in chips) 
Seat 5: bluesteele (5060 in chips) 
Seat 6: catdaddy43 (1140 in chips) 
Seat 7: brens420 (1290 in chips) is sitting out
Seat 8: TheBigAceT (1545 in chips) 
Seat 9: Perc60 (800 in chips) 
brens420: posts small blind 25
TheBigAceT: posts big blind 50
*** HOLE CARDS ***
Dealt to Starstealer [Jd Kd]
Perc60: raises 50 to 100
Starstealer: folds 
bjackmurray: calls 100
NoleSAK: folds 
awaone: folds 
bluesteele: folds 
catdaddy43: folds 
brens420: folds 
TheBigAceT: folds 
*** FLOP *** [Jc Qh 5h]
Perc60: checks 
bjackmurray: bets 50
Perc60: raises 50 to 100
bjackmurray: calls 50
*** TURN *** [Jc Qh 5h] [Td]
Perc60: bets 100
bjackmurray: calls 100
*** RIVER *** [Jc Qh 5h Td] [6c]
Perc60: bets 100
bjackmurray: folds 
Perc60 collected 675 from  pot
*** SUMMARY ***
Total pot 675 | Rake 0 
Board [Jc Qh 5h Td 6c]
Seat 1: Starstealer folded before Flop (didn't bet)
Seat 2: bjackmurray folded on the River
Seat 3: NoleSAK folded before Flop (didn't bet)
Seat 4: awaone folded before Flop (didn't bet)
Seat 5: bluesteele folded before Flop (didn't bet)
Seat 6: catdaddy43 (button) folded before Flop (didn't bet)
Seat 7: brens420 (small blind) folded before Flop
Seat 8: TheBigAceT (big blind) folded before Flop
Seat 9: Perc60 collected (675)

*********** # 33 **************
PokerStars Game #136547069: Tournament #376033, Hold'em Limit - Level III (50/100) - 2003/10/05 - 00:39:09 (ET)
Table '376033 3' Seat #7 is the button
Seat 1: Starstealer (1300 in chips) 
Seat 2: bjackmurray (1465 in chips) 
Seat 3: NoleSAK (475 in chips) 
Seat 4: awaone (1875 in chips) 
Seat 5: bluesteele (5060 in chips) 
Seat 6: catdaddy43 (1140 in chips) 
Seat 7: brens420 (1265 in chips) is sitting out
Seat 8: TheBigAceT (1495 in chips) 
Seat 9: Perc60 (1175 in chips) 
TheBigAceT: posts small blind 25
Perc60: posts big blind 50
*** HOLE CARDS ***
Dealt to Starstealer [7d Kc]
Starstealer: folds 
bjackmurray: folds 
NoleSAK: folds 
awaone: folds 
bluesteele: calls 50
catdaddy43: folds 
brens420: folds 
TheBigAceT: folds 
Perc60: checks 
*** FLOP *** [6h Ad Ac]
Perc60: checks 
bluesteele: bets 50
Perc60: folds 
bluesteele collected 125 from  pot
bluesteele: doesn't show hand 
*** SUMMARY ***
Total pot 125 | Rake 0 
Board [6h Ad Ac]
Seat 1: Starstealer folded before Flop (didn't bet)
Seat 2: bjackmurray folded before Flop (didn't bet)
Seat 3: NoleSAK folded before Flop (didn't bet)
Seat 4: awaone folded before Flop (didn't bet)
Seat 5: bluesteele collected (125)
Seat 6: catdaddy43 folded before Flop (didn't bet)
Seat 7: brens420 (button) folded before Flop (didn't bet)
Seat 8: TheBigAceT (small blind) folded before Flop
Seat 9: Perc60 (big blind) folded on the Flop

*********** # 34 **************
PokerStars Game #136547621: Tournament #376033, Hold'em Limit - Level III (50/100) - 2003/10/05 - 00:39:47 (ET)
Table '376033 3' Seat #8 is the button
Seat 1: Starstealer (1300 in chips) 
Seat 2: bjackmurray (1465 in chips) 
Seat 3: NoleSAK (475 in chips) 
Seat 4: awaone (1875 in chips) 
Seat 5: bluesteele (5135 in chips) 
Seat 6: catdaddy43 (1140 in chips) 
Seat 7: brens420 (1265 in chips) is sitting out
Seat 8: TheBigAceT (1470 in chips) 
Seat 9: Perc60 (1125 in chips) 
Perc60: posts small blind 25
Starstealer: posts big blind 50
*** HOLE CARDS ***
Dealt to Starstealer [8d 4c]
bjackmurray: folds 
NoleSAK: raises 50 to 100
awaone: folds 
bluesteele: folds 
catdaddy43: calls 100
brens420: folds 
TheBigAceT: folds 
Perc60: calls 75
Starstealer: folds 
*** FLOP *** [9h 6s 3d]
Perc60: checks 
NoleSAK: checks 
catdaddy43: checks 
*** TURN *** [9h 6s 3d] [3c]
Perc60: checks 
NoleSAK: checks 
catdaddy43: checks 
*** RIVER *** [9h 6s 3d 3c] [5h]
Perc60: checks 
NoleSAK: checks 
catdaddy43: checks 
*** SHOW DOWN ***
Perc60: shows [8s 2s] (a pair of Threes)
NoleSAK: shows [Ts Js] (a pair of Threes - Jack kicker)
catdaddy43: mucks hand 
NoleSAK collected 350 from  pot
*** SUMMARY ***
Total pot 350 | Rake 0 
Board [9h 6s 3d 3c 5h]
Seat 1: Starstealer (big blind) folded before Flop
Seat 2: bjackmurray folded before Flop (didn't bet)
Seat 3: NoleSAK showed [Ts Js] and won (350) with a pair of Threes
Seat 4: awaone folded before Flop (didn't bet)
Seat 5: bluesteele folded before Flop (didn't bet)
Seat 6: catdaddy43 mucked [Jh 4h] - a pair of Threes
Seat 7: brens420 folded before Flop (didn't bet)
Seat 8: TheBigAceT (button) folded before Flop (didn't bet)
Seat 9: Perc60 (small blind) showed [8s 2s] and lost with a pair of Threes

*********** # 35 **************
PokerStars Game #136548925: Tournament #376033, Hold'em Limit - Level III (50/100) - 2003/10/05 - 00:41:15 (ET)
Table '376033 3' Seat #9 is the button
Seat 1: Starstealer (1250 in chips) 
Seat 2: bjackmurray (1465 in chips) 
Seat 3: NoleSAK (725 in chips) 
Seat 4: awaone (1875 in chips) 
Seat 5: bluesteele (5135 in chips) 
Seat 6: catdaddy43 (1040 in chips) 
Seat 7: brens420 (1265 in chips) is sitting out
Seat 8: TheBigAceT (1470 in chips) 
Seat 9: Perc60 (1025 in chips) 
Starstealer: posts small blind 25
bjackmurray: posts big blind 50
*** HOLE CARDS ***
Dealt to Starstealer [Js Qh]
NoleSAK: raises 50 to 100
awaone: folds 
bluesteele: calls 100
catdaddy43: folds 
brens420: folds 
TheBigAceT: folds 
Perc60: calls 100
Starstealer: folds 
bjackmurray: folds 
*** FLOP *** [9c 5h 7h]
NoleSAK: checks 
bluesteele: bets 50
Perc60: raises 50 to 100
NoleSAK: folds 
bluesteele: raises 50 to 150
Perc60: calls 50
*** TURN *** [9c 5h 7h] [9s]
bluesteele: bets 100
Perc60: raises 100 to 200
bluesteele: calls 100
*** RIVER *** [9c 5h 7h 9s] [Kd]
bluesteele: checks 
Perc60: bets 100
bluesteele: calls 100
*** SHOW DOWN ***
Perc60: shows [Ks 5c] (two pair, Kings and Nines)
bluesteele: mucks hand 
Perc60 collected 1275 from  pot
*** SUMMARY ***
Total pot 1275 | Rake 0 
Board [9c 5h 7h 9s Kd]
Seat 1: Starstealer (small blind) folded before Flop
Seat 2: bjackmurray (big blind) folded before Flop
Seat 3: NoleSAK folded on the Flop
Seat 4: awaone folded before Flop (didn't bet)
Seat 5: bluesteele mucked [Qc 8d] - a pair of Nines
Seat 6: catdaddy43 folded before Flop (didn't bet)
Seat 7: brens420 folded before Flop (didn't bet)
Seat 8: TheBigAceT folded before Flop (didn't bet)
Seat 9: Perc60 (button) showed [Ks 5c] and won (1275) with two pair, Kings and Nines

*********** # 36 **************
PokerStars Game #136550013: Tournament #376033, Hold'em Limit - Level III (50/100) - 2003/10/05 - 00:42:28 (ET)
Table '376033 3' Seat #1 is the button
Seat 1: Starstealer (1225 in chips) 
Seat 2: bjackmurray (1415 in chips) 
Seat 3: NoleSAK (625 in chips) 
Seat 4: awaone (1875 in chips) 
Seat 5: bluesteele (4585 in chips) 
Seat 6: catdaddy43 (1040 in chips) 
Seat 7: brens420 (1265 in chips) is sitting out
Seat 8: TheBigAceT (1470 in chips) 
Seat 9: Perc60 (1750 in chips) 
bjackmurray: posts small blind 25
NoleSAK: posts big blind 50
*** HOLE CARDS ***
Dealt to Starstealer [5d 3h]
awaone: folds 
bluesteele: calls 50
catdaddy43: calls 50
brens420: folds 
TheBigAceT: calls 50
Perc60: calls 50
Starstealer: folds 
bjackmurray: folds 
NoleSAK: checks 
*** FLOP *** [Td Kh 3c]
NoleSAK: checks 
bluesteele: bets 50
catdaddy43: folds 
TheBigAceT: folds 
Perc60: folds 
NoleSAK: folds 
bluesteele collected 275 from  pot
bluesteele: doesn't show hand 
*** SUMMARY ***
Total pot 275 | Rake 0 
Board [Td Kh 3c]
Seat 1: Starstealer (button) folded before Flop (didn't bet)
Seat 2: bjackmurray (small blind) folded before Flop
Seat 3: NoleSAK (big blind) folded on the Flop
Seat 4: awaone folded before Flop (didn't bet)
Seat 5: bluesteele collected (275)
Seat 6: catdaddy43 folded on the Flop
Seat 7: brens420 folded before Flop (didn't bet)
Seat 8: TheBigAceT folded on the Flop
Seat 9: Perc60 folded on the Flop

*********** # 37 **************
PokerStars Game #136550835: Tournament #376033, Hold'em Limit - Level III (50/100) - 2003/10/05 - 00:43:24 (ET)
Table '376033 3' Seat #2 is the button
Seat 1: Starstealer (1225 in chips) 
Seat 2: bjackmurray (1390 in chips) 
Seat 3: NoleSAK (575 in chips) 
Seat 4: awaone (1875 in chips) 
Seat 5: bluesteele (4810 in chips) 
Seat 6: catdaddy43 (990 in chips) 
Seat 7: brens420 (1265 in chips) is sitting out
Seat 8: TheBigAceT (1420 in chips) 
Seat 9: Perc60 (1700 in chips) 
NoleSAK: posts small blind 25
awaone: posts big blind 50
*** HOLE CARDS ***
Dealt to Starstealer [6s Tc]
bluesteele: calls 50
catdaddy43: calls 50
brens420: folds 
TheBigAceT: folds 
Perc60: calls 50
Starstealer: folds 
bjackmurray: folds 
NoleSAK: calls 25
awaone: checks 
*** FLOP *** [4s 3d Ad]
NoleSAK: bets 50
awaone: calls 50
bluesteele: calls 50
catdaddy43: folds 
Perc60: calls 50
*** TURN *** [4s 3d Ad] [9s]
NoleSAK: bets 100
awaone: folds 
bluesteele: calls 100
Perc60: folds 
*** RIVER *** [4s 3d Ad 9s] [3c]
NoleSAK: bets 100
bluesteele: folds 
NoleSAK collected 650 from  pot
*** SUMMARY ***
Total pot 650 | Rake 0 
Board [4s 3d Ad 9s 3c]
Seat 1: Starstealer folded before Flop (didn't bet)
Seat 2: bjackmurray (button) folded before Flop (didn't bet)
Seat 3: NoleSAK (small blind) collected (650)
Seat 4: awaone (big blind) folded on the Turn
Seat 5: bluesteele folded on the River
Seat 6: catdaddy43 folded on the Flop
Seat 7: brens420 folded before Flop (didn't bet)
Seat 8: TheBigAceT folded before Flop (didn't bet)
Seat 9: Perc60 folded on the Turn

*********** # 38 **************
PokerStars Game #136552126: Tournament #376033, Hold'em Limit - Level IV (100/200) - 2003/10/05 - 00:44:49 (ET)
Table '376033 3' Seat #3 is the button
Seat 1: Starstealer (1225 in chips) 
Seat 2: bjackmurray (1390 in chips) 
Seat 3: NoleSAK (1025 in chips) 
Seat 4: awaone (1775 in chips) 
Seat 5: bluesteele (4610 in chips) 
Seat 6: catdaddy43 (940 in chips) 
Seat 7: brens420 (1265 in chips) is sitting out
Seat 8: TheBigAceT (1420 in chips) 
Seat 9: Perc60 (1600 in chips) 
awaone: posts small blind 50
bluesteele: posts big blind 100
*** HOLE CARDS ***
Dealt to Starstealer [2c 9h]
catdaddy43: folds 
brens420: folds 
TheBigAceT: raises 100 to 200
Perc60: calls 200
Starstealer: folds 
bjackmurray: calls 200
NoleSAK: folds 
awaone: folds 
bluesteele: folds 
*** FLOP *** [5c 2h 8c]
TheBigAceT: bets 100
Perc60: calls 100
bjackmurray: calls 100
*** TURN *** [5c 2h 8c] [4d]
TheBigAceT: checks 
Perc60: checks 
bjackmurray: bets 200
TheBigAceT: folds 
Perc60: calls 200
*** RIVER *** [5c 2h 8c 4d] [Ts]
Perc60: checks 
bjackmurray: bets 200
Perc60: folds 
bjackmurray collected 1450 from  pot
bjackmurray: doesn't show hand 
*** SUMMARY ***
Total pot 1450 | Rake 0 
Board [5c 2h 8c 4d Ts]
Seat 1: Starstealer folded before Flop (didn't bet)
Seat 2: bjackmurray collected (1450)
Seat 3: NoleSAK (button) folded before Flop (didn't bet)
Seat 4: awaone (small blind) folded before Flop
Seat 5: bluesteele (big blind) folded before Flop
Seat 6: catdaddy43 folded before Flop (didn't bet)
Seat 7: brens420 folded before Flop (didn't bet)
Seat 8: TheBigAceT folded on the Turn
Seat 9: Perc60 folded on the River

*********** # 39 **************
PokerStars Game #136553312: Tournament #376033, Hold'em Limit - Level IV (100/200) - 2003/10/05 - 00:46:09 (ET)
Table '376033 3' Seat #4 is the button
Seat 1: Starstealer (1225 in chips) 
Seat 2: bjackmurray (2340 in chips) 
Seat 3: NoleSAK (1025 in chips) 
Seat 4: awaone (1725 in chips) 
Seat 5: bluesteele (4510 in chips) 
Seat 6: catdaddy43 (940 in chips) 
Seat 7: brens420 (1265 in chips) is sitting out
Seat 8: TheBigAceT (1120 in chips) 
Seat 9: Perc60 (1100 in chips) 
bluesteele: posts small blind 50
catdaddy43: posts big blind 100
*** HOLE CARDS ***
Dealt to Starstealer [Td Tc]
brens420: folds 
TheBigAceT: folds 
Perc60: raises 100 to 200
Starstealer: calls 200
bjackmurray: folds 
NoleSAK: folds 
awaone: calls 200
bluesteele: calls 150
catdaddy43: calls 100
*** FLOP *** [9h 4d 6d]
bluesteele: checks 
catdaddy43: checks 
Perc60: bets 100
Starstealer: calls 100
awaone: folds 
bluesteele: folds 
catdaddy43: folds 
*** TURN *** [9h 4d 6d] [6s]
Perc60: bets 200
Starstealer: calls 200
*** RIVER *** [9h 4d 6d 6s] [Ac]
Perc60: checks 
Starstealer: checks 
*** SHOW DOWN ***
Perc60: shows [Qd Kd] (a pair of Sixes)
Starstealer: shows [Td Tc] (two pair, Tens and Sixes)
Starstealer collected 1600 from  pot
*** SUMMARY ***
Total pot 1600 | Rake 0 
Board [9h 4d 6d 6s Ac]
Seat 1: Starstealer showed [Td Tc] and won (1600) with two pair, Tens and Sixes
Seat 2: bjackmurray folded before Flop (didn't bet)
Seat 3: NoleSAK folded before Flop (didn't bet)
Seat 4: awaone (button) folded on the Flop
Seat 5: bluesteele (small blind) folded on the Flop
Seat 6: catdaddy43 (big blind) folded on the Flop
Seat 7: brens420 folded before Flop (didn't bet)
Seat 8: TheBigAceT folded before Flop (didn't bet)
Seat 9: Perc60 showed [Qd Kd] and lost with a pair of Sixes

*********** # 40 **************
PokerStars Game #136554967: Tournament #376033, Hold'em Limit - Level IV (100/200) - 2003/10/05 - 00:48:01 (ET)
Table '376033 3' Seat #5 is the button
Seat 1: Starstealer (2325 in chips) 
Seat 2: bjackmurray (2340 in chips) 
Seat 3: NoleSAK (1025 in chips) 
Seat 4: awaone (1525 in chips) 
Seat 5: bluesteele (4310 in chips) 
Seat 6: catdaddy43 (740 in chips) 
Seat 7: brens420 (1265 in chips) is sitting out
Seat 8: TheBigAceT (1120 in chips) 
Seat 9: Perc60 (600 in chips) 
catdaddy43: posts small blind 50
brens420: posts big blind 100
*** HOLE CARDS ***
Dealt to Starstealer [Qh 3s]
TheBigAceT: folds 
Perc60: calls 100
Starstealer: folds 
bjackmurray: folds 
NoleSAK: calls 100
awaone: folds 
bluesteele: folds 
catdaddy43: calls 50
brens420: folds 
*** FLOP *** [Ts Jh Kh]
catdaddy43: checks 
Perc60: bets 100
NoleSAK: calls 100
catdaddy43: calls 100
*** TURN *** [Ts Jh Kh] [Ac]
catdaddy43: checks 
Perc60: bets 200
NoleSAK: folds 
catdaddy43: calls 200
*** RIVER *** [Ts Jh Kh Ac] [Qs]
NoleSAK said, "F"
catdaddy43: checks 
Perc60: bets 200 and is all-in
catdaddy43: calls 200
*** SHOW DOWN ***
Perc60: shows [8h Kc] (a straight, Ten to Ace)
catdaddy43: shows [4c Ah] (a straight, Ten to Ace)
catdaddy43 collected 750 from  pot
Perc60 collected 750 from  pot
*** SUMMARY ***
Total pot 1500 | Rake 0 
Board [Ts Jh Kh Ac Qs]
Seat 1: Starstealer folded before Flop (didn't bet)
Seat 2: bjackmurray folded before Flop (didn't bet)
Seat 3: NoleSAK folded on the Turn
Seat 4: awaone folded before Flop (didn't bet)
Seat 5: bluesteele (button) folded before Flop (didn't bet)
Seat 6: catdaddy43 (small blind) showed [4c Ah] and won (750) with a straight, Ten to Ace
Seat 7: brens420 (big blind) folded before Flop
Seat 8: TheBigAceT folded before Flop (didn't bet)
Seat 9: Perc60 showed [8h Kc] and won (750) with a straight, Ten to Ace

*********** # 41 **************
PokerStars Game #136556216: Tournament #376033, Hold'em Limit - Level IV (100/200) - 2003/10/05 - 00:49:26 (ET)
Table '376033 3' Seat #6 is the button
Seat 1: Starstealer (2325 in chips) 
Seat 2: bjackmurray (2340 in chips) 
Seat 3: NoleSAK (825 in chips) 
Seat 4: awaone (1525 in chips) 
Seat 5: bluesteele (4310 in chips) 
Seat 6: catdaddy43 (890 in chips) 
Seat 7: brens420 (1165 in chips) is sitting out
Seat 8: TheBigAceT (1120 in chips) 
Seat 9: Perc60 (750 in chips) 
brens420: posts small blind 50
TheBigAceT: posts big blind 100
*** HOLE CARDS ***
Dealt to Starstealer [4s 4c]
Perc60: calls 100
Starstealer: raises 100 to 200
bjackmurray: folds 
NoleSAK: folds 
awaone: folds 
bluesteele: folds 
catdaddy43: calls 200
brens420: folds 
TheBigAceT: folds 
Perc60: raises 100 to 300
Starstealer: calls 100
catdaddy43: calls 100
*** FLOP *** [7c 5c 5s]
Perc60: bets 100
Starstealer: calls 100
catdaddy43: folds 
*** TURN *** [7c 5c 5s] [Qs]
Perc60: bets 200
Starstealer: raises 200 to 400
Perc60: calls 150 and is all-in
*** RIVER *** [7c 5c 5s Qs] [Kc]
*** SHOW DOWN ***
Perc60: shows [3c Ad] (a pair of Fives)
Starstealer: shows [4s 4c] (two pair, Fives and Fours)
Starstealer collected 1950 from  pot
*** SUMMARY ***
Total pot 1950 | Rake 0 
Board [7c 5c 5s Qs Kc]
Seat 1: Starstealer showed [4s 4c] and won (1950) with two pair, Fives and Fours
Seat 2: bjackmurray folded before Flop (didn't bet)
Seat 3: NoleSAK folded before Flop (didn't bet)
Seat 4: awaone folded before Flop (didn't bet)
Seat 5: bluesteele folded before Flop (didn't bet)
Seat 6: catdaddy43 (button) folded on the Flop
Seat 7: brens420 (small blind) folded before Flop
Seat 8: TheBigAceT (big blind) folded before Flop
Seat 9: Perc60 showed [3c Ad] and lost with a pair of Fives

*********** # 42 **************
PokerStars Game #136557462: Tournament #376033, Hold'em Limit - Level IV (100/200) - 2003/10/05 - 00:50:51 (ET)
Table '376033 3' Seat #7 is the button
Seat 1: Starstealer (3525 in chips) 
Seat 2: bjackmurray (2340 in chips) 
Seat 3: NoleSAK (825 in chips) 
Seat 4: awaone (1525 in chips) 
Seat 5: bluesteele (4310 in chips) 
Seat 6: catdaddy43 (590 in chips) 
Seat 7: brens420 (1115 in chips) is sitting out
Seat 8: TheBigAceT (1020 in chips) 
TheBigAceT: posts small blind 50
Starstealer: posts big blind 100
*** HOLE CARDS ***
Dealt to Starstealer [5s 8s]
bjackmurray: folds 
NoleSAK: calls 100
awaone: folds 
bluesteele: calls 100
catdaddy43: calls 100
brens420: folds 
TheBigAceT: folds 
Starstealer: checks 
*** FLOP *** [2s 4c 8h]
Starstealer: checks 
NoleSAK: checks 
Bill03 is connected 
bluesteele: checks 
catdaddy43: checks 
*** TURN *** [2s 4c 8h] [Jh]
Starstealer: bets 200
NoleSAK: folds 
bluesteele: folds 
catdaddy43: folds 
Starstealer collected 450 from  pot
Starstealer: doesn't show hand 
*** SUMMARY ***
Total pot 450 | Rake 0 
Board [2s 4c 8h Jh]
Seat 1: Starstealer (big blind) collected (450)
Seat 2: bjackmurray folded before Flop (didn't bet)
Seat 3: NoleSAK folded on the Turn
Seat 4: awaone folded before Flop (didn't bet)
Seat 5: bluesteele folded on the Turn
Seat 6: catdaddy43 folded on the Turn
Seat 7: brens420 (button) folded before Flop (didn't bet)
Seat 8: TheBigAceT (small blind) folded before Flop

*********** # 43 **************
PokerStars Game #136558613: Tournament #376033, Hold'em Limit - Level IV (100/200) - 2003/10/05 - 00:52:12 (ET)
Table '376033 3' Seat #8 is the button
Seat 1: Starstealer (3875 in chips) 
Seat 2: bjackmurray (2340 in chips) 
Seat 3: NoleSAK (725 in chips) 
Seat 4: awaone (1525 in chips) 
Seat 5: bluesteele (4210 in chips) 
Seat 6: catdaddy43 (490 in chips) 
Seat 7: brens420 (1115 in chips) is sitting out
Seat 8: TheBigAceT (970 in chips) 
Seat 9: Bill03 (320 in chips) out of hand (moved from another table into small blind)
Starstealer: posts small blind 50
bjackmurray: posts big blind 100
*** HOLE CARDS ***
Dealt to Starstealer [9d Jh]
NoleSAK: calls 100
awaone: folds 
bluesteele: calls 100
catdaddy43: calls 100
brens420: folds 
TheBigAceT: folds 
Starstealer: folds 
bjackmurray: checks 
*** FLOP *** [Th Js 7c]
bjackmurray: checks 
NoleSAK: checks 
bluesteele: bets 100
catdaddy43: folds 
bjackmurray: folds 
NoleSAK: folds 
bluesteele collected 450 from  pot
bluesteele: doesn't show hand 
*** SUMMARY ***
Total pot 450 | Rake 0 
Board [Th Js 7c]
Seat 1: Starstealer (small blind) folded before Flop
Seat 2: bjackmurray (big blind) folded on the Flop
Seat 3: NoleSAK folded on the Flop
Seat 4: awaone folded before Flop (didn't bet)
Seat 5: bluesteele collected (450)
Seat 6: catdaddy43 folded on the Flop
Seat 7: brens420 folded before Flop (didn't bet)
Seat 8: TheBigAceT (button) folded before Flop (didn't bet)

*********** # 44 **************
PokerStars Game #136559462: Tournament #376033, Hold'em Limit - Level IV (100/200) - 2003/10/05 - 00:53:11 (ET)
Table '376033 3' Seat #1 is the button
Seat 1: Starstealer (3825 in chips) 
Seat 2: bjackmurray (2240 in chips) 
Seat 3: NoleSAK (625 in chips) 
Seat 4: awaone (1525 in chips) 
Seat 5: bluesteele (4560 in chips) 
Seat 6: catdaddy43 (390 in chips) 
Seat 7: brens420 (1115 in chips) is sitting out
Seat 8: TheBigAceT (970 in chips) 
Seat 9: Bill03 (320 in chips) 
bjackmurray: posts small blind 50
NoleSAK: posts big blind 100
*** HOLE CARDS ***
Dealt to Starstealer [Jd Ac]
awaone: folds 
bluesteele: calls 100
catdaddy43: calls 100
brens420: folds 
TheBigAceT: folds 
Bill03: folds 
Starstealer: folds 
bjackmurray: folds 
NoleSAK: checks 
*** FLOP *** [Ts 9c 9s]
NoleSAK: checks 
bluesteele: checks 
catdaddy43: bets 100
NoleSAK: folds 
bluesteele: calls 100
*** TURN *** [Ts 9c 9s] [3c]
bluesteele: checks 
catdaddy43: bets 190 and is all-in
bluesteele: folds 
catdaddy43 collected 550 from  pot
catdaddy43: doesn't show hand 
*** SUMMARY ***
Total pot 550 | Rake 0 
Board [Ts 9c 9s 3c]
Seat 1: Starstealer (button) folded before Flop (didn't bet)
Seat 2: bjackmurray (small blind) folded before Flop
Seat 3: NoleSAK (big blind) folded on the Flop
Seat 4: awaone folded before Flop (didn't bet)
Seat 5: bluesteele folded on the Turn
Seat 6: catdaddy43 collected (550)
Seat 7: brens420 folded before Flop (didn't bet)
Seat 8: TheBigAceT folded before Flop (didn't bet)
Seat 9: Bill03 folded before Flop (didn't bet)

*********** # 45 **************
PokerStars Game #136560827: Tournament #376033, Hold'em Limit - Level IV (100/200) - 2003/10/05 - 00:54:45 (ET)
Table '376033 3' Seat #2 is the button
Seat 1: Starstealer (3825 in chips) 
Seat 2: bjackmurray (2190 in chips) 
Seat 3: NoleSAK (525 in chips) 
Seat 4: awaone (1525 in chips) 
Seat 5: bluesteele (4360 in chips) 
Seat 6: catdaddy43 (740 in chips) 
Seat 7: brens420 (1115 in chips) is sitting out
Seat 8: TheBigAceT (970 in chips) 
Seat 9: Bill03 (320 in chips) 
NoleSAK: posts small blind 50
awaone: posts big blind 100
*** HOLE CARDS ***
Dealt to Starstealer [4c 5c]
bluesteele: calls 100
catdaddy43: calls 100
brens420: folds 
TheBigAceT: folds 
Bill03: calls 100
Starstealer: folds 
bjackmurray: calls 100
NoleSAK: calls 50
awaone: checks 
*** FLOP *** [Qd 4d Kd]
NoleSAK: checks 
awaone: checks 
bluesteele: bets 100
catdaddy43: folds 
Bill03: calls 100
awaone is disconnected 
awaone is connected 
bjackmurray: folds 
NoleSAK: folds 
awaone: folds 
*** TURN *** [Qd 4d Kd] [8h]
bluesteele: bets 200
Bill03: folds 
bluesteele collected 800 from  pot
bluesteele: doesn't show hand 
*** SUMMARY ***
Total pot 800 | Rake 0 
Board [Qd 4d Kd 8h]
Seat 1: Starstealer folded before Flop (didn't bet)
Seat 2: bjackmurray (button) folded on the Flop
Seat 3: NoleSAK (small blind) folded on the Flop
Seat 4: awaone (big blind) folded on the Flop
Seat 5: bluesteele collected (800)
Seat 6: catdaddy43 folded on the Flop
Seat 7: brens420 folded before Flop (didn't bet)
Seat 8: TheBigAceT folded before Flop (didn't bet)
Seat 9: Bill03 folded on the Turn

*********** # 46 **************
PokerStars Game #136562415: Tournament #376033, Hold'em Limit - Level IV (100/200) - 2003/10/05 - 00:56:34 (ET)
Table '376033 3' Seat #3 is the button
Seat 1: Starstealer (3825 in chips) 
Seat 2: bjackmurray (2090 in chips) 
Seat 3: NoleSAK (425 in chips) 
Seat 4: awaone (1425 in chips) 
Seat 5: bluesteele (4960 in chips) 
Seat 6: catdaddy43 (640 in chips) 
Seat 7: brens420 (1115 in chips) is sitting out
Seat 8: TheBigAceT (970 in chips) 
Seat 9: Bill03 (120 in chips) 
awaone: posts small blind 50
bluesteele: posts big blind 100
*** HOLE CARDS ***
Dealt to Starstealer [5h 4c]
catdaddy43: calls 100
brens420: folds 
TheBigAceT: folds 
Bill03: calls 100
Starstealer: folds 
bjackmurray: folds 
NoleSAK: folds 
awaone: calls 50
bluesteele: checks 
*** FLOP *** [Kd Ac Qs]
awaone: bets 100
bluesteele: calls 100
catdaddy43: calls 100
Bill03: calls 20 and is all-in
*** TURN *** [Kd Ac Qs] [9s]
awaone: checks 
bluesteele: checks 
catdaddy43: bets 200
awaone: folds 
bluesteele: calls 200
*** RIVER *** [Kd Ac Qs 9s] [4s]
bluesteele: checks 
catdaddy43: bets 200
bluesteele: calls 200
*** SHOW DOWN ***
catdaddy43: shows [3s Ts] (a flush, Queen high)
bluesteele: mucks hand 
catdaddy43 collected 1040 from side pot
Bill03: mucks hand 
catdaddy43 collected 480 from main pot
pelo24 is connected 
*** SUMMARY ***
Total pot 1520 Main pot 480. Side pot 1040. | Rake 0 
Board [Kd Ac Qs 9s 4s]
Seat 1: Starstealer folded before Flop (didn't bet)
Seat 2: bjackmurray folded before Flop (didn't bet)
Seat 3: NoleSAK (button) folded before Flop (didn't bet)
Seat 4: awaone (small blind) folded on the Turn
Seat 5: bluesteele (big blind) mucked [Kh 7s] - a pair of Kings
Seat 6: catdaddy43 showed [3s Ts] and won (1520) with a flush, Queen high
Seat 7: brens420 folded before Flop (didn't bet)
Seat 8: TheBigAceT folded before Flop (didn't bet)
Seat 9: Bill03 mucked [9c Ah] - two pair, Aces and Nines

*********** # 47 **************
PokerStars Game #136564087: Tournament #376033, Hold'em Limit - Level IV (100/200) - 2003/10/05 - 00:58:30 (ET)
Table '376033 3' Seat #4 is the button
Seat 1: Starstealer (3825 in chips) 
Seat 2: bjackmurray (2090 in chips) 
Seat 3: NoleSAK (425 in chips) 
Seat 4: awaone (1225 in chips) 
Seat 5: bluesteele (4360 in chips) 
Seat 6: catdaddy43 (1560 in chips) 
Seat 7: brens420 (1115 in chips) is sitting out
Seat 8: TheBigAceT (970 in chips) 
Seat 9: pelo24 (4055 in chips) 
bluesteele: posts small blind 50
catdaddy43: posts big blind 100
*** HOLE CARDS ***
Dealt to Starstealer [3s 9h]
brens420: folds 
TheBigAceT: folds 
pelo24: calls 100
Starstealer: folds 
bjackmurray: calls 100
NoleSAK: calls 100
awaone: calls 100
bluesteele: calls 50
catdaddy43: raises 100 to 200
pelo24: folds 
bjackmurray: calls 100
NoleSAK: calls 100
awaone: calls 100
bluesteele: calls 100
*** FLOP *** [8d 9s 4c]
bluesteele: checks 
catdaddy43: bets 100
bjackmurray: raises 100 to 200
NoleSAK: folds 
awaone: folds 
bluesteele: folds 
catdaddy43: folds 
bjackmurray collected 1300 from  pot
bjackmurray: doesn't show hand 
*** SUMMARY ***
Total pot 1300 | Rake 0 
Board [8d 9s 4c]
Seat 1: Starstealer folded before Flop (didn't bet)
Seat 2: bjackmurray collected (1300)
Seat 3: NoleSAK folded on the Flop
Seat 4: awaone (button) folded on the Flop
Seat 5: bluesteele (small blind) folded on the Flop
Seat 6: catdaddy43 (big blind) folded on the Flop
Seat 7: brens420 folded before Flop (didn't bet)
Seat 8: TheBigAceT folded before Flop (didn't bet)
Seat 9: pelo24 folded before Flop

*********** # 48 **************
PokerStars Game #136569948: Tournament #376033, Hold'em Limit - Level V (150/300) - 2003/10/05 - 01:05:41 (ET)
Table '376033 3' Seat #5 is the button
Seat 1: Starstealer (3825 in chips) 
Seat 2: bjackmurray (3090 in chips) 
Seat 3: NoleSAK (225 in chips) 
Seat 4: awaone (1025 in chips) 
Seat 5: bluesteele (4160 in chips) 
Seat 6: catdaddy43 (1260 in chips) 
Seat 7: brens420 (1115 in chips) 
Seat 8: TheBigAceT (970 in chips) 
Seat 9: pelo24 (3955 in chips) 
catdaddy43: posts small blind 75
brens420: posts big blind 150
*** HOLE CARDS ***
Dealt to Starstealer [9s 5d]
TheBigAceT: folds 
pelo24: folds 
Starstealer: folds 
bjackmurray: folds 
NoleSAK: raises 75 to 225 and is all-in
awaone: calls 225
bluesteele: folds 
catdaddy43: calls 150
brens420: calls 75
*** FLOP *** [6c 6s Qd]
catdaddy43: bets 150
brens420: folds 
awaone: calls 150
*** TURN *** [6c 6s Qd] [7h]
catdaddy43: bets 300
awaone: folds 
*** RIVER *** [6c 6s Qd 7h] [Qh]
*** SHOW DOWN ***
catdaddy43: shows [Qc 9h] (a full house, Queens full of Sixes)
catdaddy43 collected 300 from side pot
NoleSAK: shows [8h Ks] (two pair, Queens and Sixes)
catdaddy43 collected 900 from main pot
*** SUMMARY ***
Total pot 1200 Main pot 900. Side pot 300. | Rake 0 
Board [6c 6s Qd 7h Qh]
Seat 1: Starstealer folded before Flop (didn't bet)
Seat 2: bjackmurray folded before Flop (didn't bet)
Seat 3: NoleSAK showed [8h Ks] and lost with two pair, Queens and Sixes
Seat 4: awaone folded on the Turn
Seat 5: bluesteele (button) folded before Flop (didn't bet)
Seat 6: catdaddy43 (small blind) showed [Qc 9h] and won (1200) with a full house, Queens full of Sixes
Seat 7: brens420 (big blind) folded on the Flop
Seat 8: TheBigAceT folded before Flop (didn't bet)
Seat 9: pelo24 folded before Flop (didn't bet)

*********** # 49 **************
PokerStars Game #136571330: Tournament #376033, Hold'em Limit - Level V (150/300) - 2003/10/05 - 01:07:21 (ET)
Table '376033 3' Seat #6 is the button
Seat 1: Starstealer (3825 in chips) 
Seat 2: bjackmurray (3090 in chips) 
Seat 4: awaone (650 in chips) 
Seat 5: bluesteele (4160 in chips) 
Seat 6: catdaddy43 (2085 in chips) 
Seat 7: brens420 (890 in chips) 
Seat 8: TheBigAceT (970 in chips) 
Seat 9: pelo24 (3955 in chips) 
brens420: posts small blind 75
TheBigAceT: posts big blind 150
*** HOLE CARDS ***
Dealt to Starstealer [Qs 8d]
ldmj is connected 
pelo24: folds 
Starstealer: folds 
bjackmurray: calls 150
awaone: folds 
bluesteele: calls 150
catdaddy43: folds 
brens420: raises 150 to 300
TheBigAceT: folds 
bjackmurray: calls 150
bluesteele: calls 150
*** FLOP *** [6c 4h As]
brens420: bets 150
bjackmurray: folds 
bluesteele: folds 
brens420 collected 1050 from  pot
brens420: doesn't show hand 
*** SUMMARY ***
Total pot 1050 | Rake 0 
Board [6c 4h As]
Seat 1: Starstealer folded before Flop (didn't bet)
Seat 2: bjackmurray folded on the Flop
Seat 4: awaone folded before Flop (didn't bet)
Seat 5: bluesteele folded on the Flop
Seat 6: catdaddy43 (button) folded before Flop (didn't bet)
Seat 7: brens420 (small blind) collected (1050)
Seat 8: TheBigAceT (big blind) folded before Flop
Seat 9: pelo24 folded before Flop (didn't bet)

*********** # 50 **************
PokerStars Game #136572066: Tournament #376033, Hold'em Limit - Level V (150/300) - 2003/10/05 - 01:08:15 (ET)
Table '376033 3' Seat #7 is the button
Seat 1: Starstealer (3825 in chips) 
Seat 2: bjackmurray (2790 in chips) 
Seat 3: ldmj (735 in chips) is sitting out
Seat 4: awaone (650 in chips) 
Seat 5: bluesteele (3860 in chips) 
Seat 6: catdaddy43 (2085 in chips) 
Seat 7: brens420 (1640 in chips) 
Seat 8: TheBigAceT (820 in chips) 
Seat 9: pelo24 (3955 in chips) 
TheBigAceT: posts small blind 75
pelo24: posts big blind 150
*** HOLE CARDS ***
Dealt to Starstealer [Ad Qc]
Starstealer: raises 150 to 300
bjackmurray: folds 
ldmj: folds 
awaone: folds 
bluesteele: calls 300
catdaddy43: calls 300
brens420: calls 300
TheBigAceT: folds 
pelo24: calls 150
*** FLOP *** [2c 9c 9d]
pelo24: bets 150
Starstealer: folds 
bluesteele: raises 150 to 300
catdaddy43: folds 
brens420: folds 
pelo24: raises 150 to 450
bluesteele: calls 150
*** TURN *** [2c 9c 9d] [Kd]
pelo24: bets 300
bluesteele: raises 300 to 600
pelo24: calls 300
*** RIVER *** [2c 9c 9d Kd] [2s]
pelo24: checks 
bluesteele: bets 300
pelo24: calls 300
*** SHOW DOWN ***
bluesteele: shows [Kh 9h] (a full house, Nines full of Kings)
pelo24: mucks hand 
bluesteele collected 4275 from  pot
*** SUMMARY ***
Total pot 4275 | Rake 0 
Board [2c 9c 9d Kd 2s]
Seat 1: Starstealer folded on the Flop
Seat 2: bjackmurray folded before Flop (didn't bet)
Seat 3: ldmj folded before Flop (didn't bet)
Seat 4: awaone folded before Flop (didn't bet)
Seat 5: bluesteele showed [Kh 9h] and won (4275) with a full house, Nines full of Kings
Seat 6: catdaddy43 folded on the Flop
Seat 7: brens420 (button) folded on the Flop
Seat 8: TheBigAceT (small blind) folded before Flop
Seat 9: pelo24 (big blind) mucked [8d 8h] - two pair, Nines and Eights

*********** # 51 **************
PokerStars Game #136573210: Tournament #376033, Hold'em Limit - Level V (150/300) - 2003/10/05 - 01:09:39 (ET)
Table '376033 3' Seat #8 is the button
Seat 1: Starstealer (3525 in chips) 
Seat 2: bjackmurray (2790 in chips) 
Seat 3: ldmj (735 in chips) is sitting out
Seat 4: awaone (650 in chips) 
Seat 5: bluesteele (6485 in chips) 
Seat 6: catdaddy43 (1785 in chips) 
Seat 7: brens420 (1340 in chips) 
Seat 8: TheBigAceT (745 in chips) 
Seat 9: pelo24 (2305 in chips) 
pelo24: posts small blind 75
Starstealer: posts big blind 150
*** HOLE CARDS ***
Dealt to Starstealer [7d Ks]
bjackmurray: folds 
ldmj: folds 
awaone: folds 
bluesteele: folds 
catdaddy43: folds 
brens420: folds 
TheBigAceT: folds 
pelo24: raises 150 to 300
Starstealer: folds 
pelo24 collected 300 from  pot
pelo24: doesn't show hand 
*** SUMMARY ***
Total pot 300 | Rake 0 
Seat 1: Starstealer (big blind) folded before Flop
Seat 2: bjackmurray folded before Flop (didn't bet)
Seat 3: ldmj folded before Flop (didn't bet)
Seat 4: awaone folded before Flop (didn't bet)
Seat 5: bluesteele folded before Flop (didn't bet)
Seat 6: catdaddy43 folded before Flop (didn't bet)
Seat 7: brens420 folded before Flop (didn't bet)
Seat 8: TheBigAceT (button) folded before Flop (didn't bet)
Seat 9: pelo24 (small blind) collected (300)

*********** # 52 **************
PokerStars Game #136573730: Tournament #376033, Hold'em Limit - Level V (150/300) - 2003/10/05 - 01:10:15 (ET)
Table '376033 3' Seat #9 is the button
Seat 1: Starstealer (3375 in chips) 
Seat 2: bjackmurray (2790 in chips) 
Seat 3: ldmj (735 in chips) is sitting out
Seat 4: awaone (650 in chips) 
Seat 5: bluesteele (6485 in chips) 
Seat 6: catdaddy43 (1785 in chips) 
Seat 7: brens420 (1340 in chips) 
Seat 8: TheBigAceT (745 in chips) 
Seat 9: pelo24 (2455 in chips) 
Starstealer: posts small blind 75
bjackmurray: posts big blind 150
*** HOLE CARDS ***
Dealt to Starstealer [Qc 5h]
ldmj: folds 
awaone: folds 
bluesteele: folds 
catdaddy43: calls 150
brens420: calls 150
TheBigAceT: folds 
pelo24: calls 150
Starstealer: folds 
bjackmurray: checks 
*** FLOP *** [Qd Ad 4h]
bjackmurray: checks 
catdaddy43: checks 
brens420: bets 150
pelo24: folds 
bjackmurray: folds 
catdaddy43: calls 150
*** TURN *** [Qd Ad 4h] [9c]
catdaddy43: checks 
brens420: bets 300
catdaddy43: calls 300
*** RIVER *** [Qd Ad 4h 9c] [8d]
catdaddy43: bets 300
brens420: calls 300
*** SHOW DOWN ***
catdaddy43: shows [Ts Jc] (a straight, Eight to Queen)
brens420: shows [5d 4d] (a flush, Ace high)
brens420 collected 2175 from  pot
*** SUMMARY ***
Total pot 2175 | Rake 0 
Board [Qd Ad 4h 9c 8d]
Seat 1: Starstealer (small blind) folded before Flop
Seat 2: bjackmurray (big blind) folded on the Flop
Seat 3: ldmj folded before Flop (didn't bet)
Seat 4: awaone folded before Flop (didn't bet)
Seat 5: bluesteele folded before Flop (didn't bet)
Seat 6: catdaddy43 showed [Ts Jc] and lost with a straight, Eight to Queen
Seat 7: brens420 showed [5d 4d] and won (2175) with a flush, Ace high
Seat 8: TheBigAceT folded before Flop (didn't bet)
Seat 9: pelo24 (button) folded on the Flop

*********** # 53 **************
PokerStars Game #136574781: Tournament #376033, Hold'em Limit - Level V (150/300) - 2003/10/05 - 01:11:32 (ET)
Table '376033 3' Seat #1 is the button
Seat 1: Starstealer (3300 in chips) 
Seat 2: bjackmurray (2640 in chips) 
Seat 3: ldmj (735 in chips) is sitting out
Seat 4: awaone (650 in chips) 
Seat 5: bluesteele (6485 in chips) 
Seat 6: catdaddy43 (885 in chips) 
Seat 7: brens420 (2615 in chips) 
Seat 8: TheBigAceT (745 in chips) 
Seat 9: pelo24 (2305 in chips) 
bjackmurray: posts small blind 75
ldmj: posts big blind 150
*** HOLE CARDS ***
Dealt to Starstealer [6h 5c]
awaone: calls 150
bluesteele: calls 150
catdaddy43: folds 
brens420: calls 150
TheBigAceT: folds 
pelo24: raises 150 to 300
Starstealer: folds 
bjackmurray: folds 
ldmj: folds 
awaone: calls 150
bluesteele: calls 150
brens420: calls 150
*** FLOP *** [5s 6c Ah]
awaone: checks 
bluesteele: checks 
brens420: checks 
pelo24: checks 
*** TURN *** [5s 6c Ah] [Jh]
awaone: bets 300
bluesteele: calls 300
brens420: calls 300
pelo24: folds 
*** RIVER *** [5s 6c Ah Jh] [7h]
awaone: bets 50 and is all-in
bluesteele: calls 50
brens420: raises 250 to 300
bluesteele: calls 250
*** SHOW DOWN ***
brens420: shows [Th 9h] (a flush, Ace high)
bluesteele: mucks hand 
brens420 collected 500 from side pot
awaone: mucks hand 
brens420 collected 2475 from main pot
*** SUMMARY ***
Total pot 2975 Main pot 2475. Side pot 500. | Rake 0 
Board [5s 6c Ah Jh 7h]
Seat 1: Starstealer (button) folded before Flop (didn't bet)
Seat 2: bjackmurray (small blind) folded before Flop
Seat 3: ldmj (big blind) folded before Flop
Seat 4: awaone mucked [Qh Qd] - a pair of Queens
Seat 5: bluesteele mucked [7c Jd] - two pair, Jacks and Sevens
Seat 6: catdaddy43 folded before Flop (didn't bet)
Seat 7: brens420 showed [Th 9h] and won (2975) with a flush, Ace high
Seat 8: TheBigAceT folded before Flop (didn't bet)
Seat 9: pelo24 folded on the Turn

*********** # 54 **************
PokerStars Game #136576133: Tournament #376033, Hold'em Limit - Level V (150/300) - 2003/10/05 - 01:13:08 (ET)
Table '376033 3' Seat #2 is the button
Seat 1: Starstealer (3300 in chips) 
Seat 2: bjackmurray (2565 in chips) 
Seat 3: ldmj (585 in chips) is sitting out
Seat 5: bluesteele (5585 in chips) 
Seat 6: catdaddy43 (885 in chips) 
Seat 7: brens420 (4690 in chips) 
Seat 8: TheBigAceT (745 in chips) 
Seat 9: pelo24 (2005 in chips) 
ldmj: posts small blind 75
bluesteele: posts big blind 150
*** HOLE CARDS ***
Dealt to Starstealer [Kd Kc]
catdaddy43: folds 
brens420: folds 
TheBigAceT: folds 
pelo24: calls 150
Starstealer: raises 150 to 300
KyDeano is connected 
bjackmurray: calls 300
ldmj: folds 
bluesteele: calls 150
pelo24: raises 150 to 450
ldmj has returned
Starstealer: calls 150
bjackmurray: calls 150
bluesteele: calls 150
*** FLOP *** [Jd Qc Kh]
bluesteele: checks 
pelo24: bets 150
Starstealer: raises 150 to 300
bjackmurray: raises 150 to 450
bluesteele: folds 
pelo24: raises 150 to 600
Betting is capped
Starstealer: calls 300
bjackmurray: calls 150
*** TURN *** [Jd Qc Kh] [8d]
pelo24: bets 300
Starstealer: calls 300
bjackmurray: raises 300 to 600
pelo24: raises 300 to 900
Starstealer: calls 600
bjackmurray: raises 300 to 1200
Betting is capped
pelo24: calls 55 and is all-in
Starstealer: calls 300
*** RIVER *** [Jd Qc Kh 8d] [9s]
Starstealer: checks 
bjackmurray: checks 
*** SHOW DOWN ***
Starstealer: shows [Kd Kc] (three of a kind, Kings)
bjackmurray: mucks hand 
Starstealer collected 490 from side pot
pelo24: shows [2d 7d] (high card King)
Starstealer collected 6540 from main pot
*** SUMMARY ***
Total pot 7030 Main pot 6540. Side pot 490. | Rake 0 
Board [Jd Qc Kh 8d 9s]
Seat 1: Starstealer showed [Kd Kc] and won (7030) with three of a kind, Kings
Seat 2: bjackmurray (button) mucked [Qh Ks] - two pair, Kings and Queens
Seat 3: ldmj (small blind) folded before Flop
Seat 5: bluesteele (big blind) folded on the Flop
Seat 6: catdaddy43 folded before Flop (didn't bet)
Seat 7: brens420 folded before Flop (didn't bet)
Seat 8: TheBigAceT folded before Flop (didn't bet)
Seat 9: pelo24 showed [2d 7d] and lost with high card King

*********** # 55 **************
PokerStars Game #136577616: Tournament #376033, Hold'em Limit - Level V (150/300) - 2003/10/05 - 01:14:53 (ET)
Table '376033 3' Seat #3 is the button
Seat 1: Starstealer (8080 in chips) 
Seat 2: bjackmurray (315 in chips) 
Seat 3: ldmj (510 in chips) 
Seat 4: KyDeano (1545 in chips) out of hand (moved from another table into small blind)
Seat 5: bluesteele (5135 in chips) 
Seat 6: catdaddy43 (885 in chips) 
Seat 7: brens420 (4690 in chips) 
Seat 8: TheBigAceT (745 in chips) 
bluesteele: posts small blind 75
catdaddy43: posts big blind 150
*** HOLE CARDS ***
Dealt to Starstealer [Jh Th]
brens420: calls 150
Iggy23 [observer] said, "nice hand star"
TheBigAceT: folds 
Starstealer: folds 
bjackmurray: raises 150 to 300
ldmj: folds 
bluesteele: calls 225
catdaddy43: folds 
brens420: raises 150 to 450
bjackmurray: calls 15 and is all-in
bluesteele: calls 150
*** FLOP *** [5d 6s 4s]
moxiejan is connected 
bluesteele: bets 150
brens420: calls 150
*** TURN *** [5d 6s 4s] [9c]
bluesteele: bets 300
brens420: calls 300
*** RIVER *** [5d 6s 4s 9c] [7d]
bluesteele: bets 300
brens420: calls 300
*** SHOW DOWN ***
bluesteele: shows [8h Td] (a straight, Six to Ten)
brens420: mucks hand 
bluesteele collected 1770 from side pot
bjackmurray: shows [Kd Kh] (a pair of Kings)
bluesteele collected 1095 from main pot
*** SUMMARY ***
Total pot 2865 Main pot 1095. Side pot 1770. | Rake 0 
Board [5d 6s 4s 9c 7d]
Seat 1: Starstealer folded before Flop (didn't bet)
Seat 2: bjackmurray showed [Kd Kh] and lost with a pair of Kings
Seat 3: ldmj (button) folded before Flop (didn't bet)
Seat 5: bluesteele (small blind) showed [8h Td] and won (2865) with a straight, Six to Ten
Seat 6: catdaddy43 (big blind) folded before Flop
Seat 7: brens420 mucked [Ks Ac] - high card Ace
Seat 8: TheBigAceT folded before Flop (didn't bet)

*********** # 56 **************
PokerStars Game #136578885: Tournament #376033, Hold'em Limit - Level V (150/300) - 2003/10/05 - 01:16:26 (ET)
Table '376033 3' Seat #5 is the button
Seat 1: Starstealer (8080 in chips) 
Seat 3: ldmj (510 in chips) 
Seat 4: KyDeano (1545 in chips) 
Seat 5: bluesteele (6800 in chips) 
Seat 6: catdaddy43 (735 in chips) 
Seat 7: brens420 (3490 in chips) 
Seat 8: TheBigAceT (745 in chips) 
Seat 9: moxiejan (2100 in chips) 
catdaddy43: posts small blind 75
brens420: posts big blind 150
*** HOLE CARDS ***
Dealt to Starstealer [2h 4s]
AnneK919 is connected 
TheBigAceT: folds 
moxiejan: folds 
Starstealer: folds 
ldmj: calls 150
KyDeano: raises 150 to 300
bluesteele: folds 
catdaddy43: folds 
brens420: raises 150 to 450
ldmj: raises 60 to 510 and is all-in
Betting is capped
KyDeano: calls 210
brens420: calls 60
*** FLOP *** [Js Kd 6h]
brens420: bets 150
KyDeano: raises 150 to 300
brens420: calls 150
*** TURN *** [Js Kd 6h] [3s]
brens420: checks 
KyDeano: checks 
*** RIVER *** [Js Kd 6h 3s] [Ts]
brens420: checks 
KyDeano: checks 
*** SHOW DOWN ***
brens420: shows [8d 9d] (high card King)
KyDeano: shows [Th As] (a pair of Tens)
KyDeano collected 600 from side pot
ldmj: mucks hand 
KyDeano collected 1605 from main pot
*** SUMMARY ***
Total pot 2205 Main pot 1605. Side pot 600. | Rake 0 
Board [Js Kd 6h 3s Ts]
Seat 1: Starstealer folded before Flop (didn't bet)
Seat 3: ldmj mucked [Qc 3c] - a pair of Threes
Seat 4: KyDeano showed [Th As] and won (2205) with a pair of Tens
Seat 5: bluesteele (button) folded before Flop (didn't bet)
Seat 6: catdaddy43 (small blind) folded before Flop
Seat 7: brens420 (big blind) showed [8d 9d] and lost with high card King
Seat 8: TheBigAceT folded before Flop (didn't bet)
Seat 9: moxiejan folded before Flop (didn't bet)

*********** # 57 **************
PokerStars Game #136579784: Tournament #376033, Hold'em Limit - Level V (150/300) - 2003/10/05 - 01:17:35 (ET)
Table '376033 3' Seat #6 is the button
Seat 1: Starstealer (8080 in chips) 
Seat 2: AnneK919 (2135 in chips) 
Seat 4: KyDeano (2940 in chips) 
Seat 5: bluesteele (6800 in chips) 
Seat 6: catdaddy43 (660 in chips) 
Seat 7: brens420 (2680 in chips) 
Seat 8: TheBigAceT (745 in chips) 
Seat 9: moxiejan (2100 in chips) 
brens420: posts small blind 75
TheBigAceT: posts big blind 150
*** HOLE CARDS ***
Dealt to Starstealer [8h Qc]
moxiejan: folds 
Starstealer: folds 
witchypoo is connected 
AnneK919: folds 
KyDeano: calls 150
bluesteele: folds 
catdaddy43: folds 
brens420: calls 75
TheBigAceT: raises 150 to 300
KyDeano: calls 150
brens420: calls 150
*** FLOP *** [As 9h Js]
brens420: checks 
TheBigAceT: bets 150
KyDeano: folds 
brens420: folds 
TheBigAceT collected 900 from  pot
TheBigAceT: doesn't show hand 
*** SUMMARY ***
Total pot 900 | Rake 0 
Board [As 9h Js]
Seat 1: Starstealer folded before Flop (didn't bet)
Seat 2: AnneK919 folded before Flop (didn't bet)
Seat 4: KyDeano folded on the Flop
Seat 5: bluesteele folded before Flop (didn't bet)
Seat 6: catdaddy43 (button) folded before Flop (didn't bet)
Seat 7: brens420 (small blind) folded on the Flop
Seat 8: TheBigAceT (big blind) collected (900)
Seat 9: moxiejan folded before Flop (didn't bet)

*********** # 58 **************
PokerStars Game #136580487: Tournament #376033, Hold'em Limit - Level V (150/300) - 2003/10/05 - 01:18:24 (ET)
Table '376033 3' Seat #7 is the button
Seat 1: Starstealer (8080 in chips) 
Seat 2: AnneK919 (2135 in chips) 
Seat 3: witchypoo (1971 in chips) 
Seat 4: KyDeano (2640 in chips) 
Seat 5: bluesteele (6800 in chips) 
Seat 6: catdaddy43 (660 in chips) 
Seat 7: brens420 (2380 in chips) 
Seat 8: TheBigAceT (1345 in chips) 
Seat 9: moxiejan (2100 in chips) 
TheBigAceT: posts small blind 75
moxiejan: posts big blind 150
*** HOLE CARDS ***
Dealt to Starstealer [2d 6d]
Starstealer: folds 
AnneK919: folds 
witchypoo: folds 
KyDeano: folds 
bluesteele: calls 150
catdaddy43: calls 150
brens420: calls 150
TheBigAceT: calls 75
moxiejan: checks 
*** FLOP *** [9c 8c Kh]
TheBigAceT: checks 
moxiejan: checks 
bluesteele: bets 150
catdaddy43: calls 150
brens420: calls 150
TheBigAceT: folds 
moxiejan: folds 
*** TURN *** [9c 8c Kh] [Ac]
bluesteele: bets 300
catdaddy43: raises 60 to 360 and is all-in
brens420: calls 360
bluesteele: calls 60
*** RIVER *** [9c 8c Kh Ac] [3d]
bluesteele: checks 
brens420: checks 
*** SHOW DOWN ***
bluesteele: shows [Ad Jh] (a pair of Aces)
catdaddy43: mucks hand 
brens420: mucks hand 
bluesteele collected 2280 from  pot
*** SUMMARY ***
Total pot 2280 | Rake 0 
Board [9c 8c Kh Ac 3d]
Seat 1: Starstealer folded before Flop (didn't bet)
Seat 2: AnneK919 folded before Flop (didn't bet)
Seat 3: witchypoo folded before Flop (didn't bet)
Seat 4: KyDeano folded before Flop (didn't bet)
Seat 5: bluesteele showed [Ad Jh] and won (2280) with a pair of Aces
Seat 6: catdaddy43 mucked [As Ts] - a pair of Aces
Seat 7: brens420 (button) mucked [Tc 7h] - high card Ace
Seat 8: TheBigAceT (small blind) folded on the Flop
Seat 9: moxiejan (big blind) folded on the Flop

*********** # 59 **************
PokerStars Game #136581651: Tournament #376033, Hold'em Limit - Level V (150/300) - 2003/10/05 - 01:19:48 (ET)
Table '376033 3' Seat #8 is the button
Seat 1: Starstealer (8080 in chips) 
Seat 2: AnneK919 (2135 in chips) 
Seat 3: witchypoo (1971 in chips) 
Seat 4: KyDeano (2640 in chips) 
Seat 5: bluesteele (8420 in chips) 
Seat 6: aeneas23 (2865 in chips) 
Seat 7: brens420 (1720 in chips) 
Seat 8: TheBigAceT (1195 in chips) 
Seat 9: moxiejan (1950 in chips) 
moxiejan: posts small blind 75
Starstealer: posts big blind 150
*** HOLE CARDS ***
Dealt to Starstealer [Ac 9s]
AnneK919: calls 150
witchypoo: folds 
KyDeano: calls 150
bluesteele: calls 150
aeneas23: folds 
brens420: folds 
TheBigAceT: folds 
moxiejan: folds 
Starstealer: checks 
*** FLOP *** [Tc 2d Kc]
Starstealer: checks 
AnneK919: checks 
KyDeano: checks 
bluesteele: bets 150
Starstealer: folds 
AnneK919: folds 
KyDeano: calls 150
*** TURN *** [Tc 2d Kc] [5c]
KyDeano: checks 
bluesteele: bets 300
KyDeano: folds 
bluesteele collected 975 from  pot
bluesteele: doesn't show hand 
*** SUMMARY ***
Total pot 975 | Rake 0 
Board [Tc 2d Kc 5c]
Seat 1: Starstealer (big blind) folded on the Flop
Seat 2: AnneK919 folded on the Flop
Seat 3: witchypoo folded before Flop (didn't bet)
Seat 4: KyDeano folded on the Turn
Seat 5: bluesteele collected (975)
Seat 6: aeneas23 folded before Flop (didn't bet)
Seat 7: brens420 folded before Flop (didn't bet)
Seat 8: TheBigAceT (button) folded before Flop (didn't bet)
Seat 9: moxiejan (small blind) folded before Flop

*********** # 60 **************
PokerStars Game #136582610: Tournament #376033, Hold'em Limit - Level VI (200/400) - 2003/10/05 - 01:20:58 (ET)
Table '376033 3' Seat #9 is the button
Seat 1: Starstealer (7930 in chips) 
Seat 2: AnneK919 (1985 in chips) 
Seat 3: witchypoo (1971 in chips) 
Seat 4: KyDeano (2340 in chips) 
Seat 5: bluesteele (9095 in chips) 
Seat 6: aeneas23 (2865 in chips) 
Seat 7: brens420 (1720 in chips) 
Seat 8: TheBigAceT (1195 in chips) 
Seat 9: moxiejan (1875 in chips) 
Starstealer: posts small blind 100
AnneK919: posts big blind 200
*** HOLE CARDS ***
Dealt to Starstealer [9s 7s]
witchypoo: raises 200 to 400
KyDeano: calls 400
bluesteele: calls 400
aeneas23: folds 
brens420: raises 200 to 600
TheBigAceT: folds 
moxiejan: folds 
Starstealer: folds 
AnneK919: folds 
witchypoo: raises 200 to 800
Betting is capped
KyDeano: calls 400
bluesteele: calls 400
brens420: calls 200
*** FLOP *** [Ad 9h Kd]
witchypoo: checks 
KyDeano: checks 
bluesteele: bets 200
brens420: raises 200 to 400
witchypoo: folds 
KyDeano: folds 
bluesteele: calls 200
*** TURN *** [Ad 9h Kd] [3c]
bluesteele: checks 
brens420: bets 400
bluesteele: calls 400
*** RIVER *** [Ad 9h Kd 3c] [5d]
bluesteele: bets 400
brens420: calls 120 and is all-in
*** SHOW DOWN ***
bluesteele: shows [Td Qd] (a flush, Ace high)
brens420: shows [Jc Ac] (a pair of Aces)
bluesteele collected 5340 from  pot
*** SUMMARY ***
Total pot 5340 | Rake 0 
Board [Ad 9h Kd 3c 5d]
Seat 1: Starstealer (small blind) folded before Flop
Seat 2: AnneK919 (big blind) folded before Flop
Seat 3: witchypoo folded on the Flop
Seat 4: KyDeano folded on the Flop
Seat 5: bluesteele showed [Td Qd] and won (5340) with a flush, Ace high
Seat 6: aeneas23 folded before Flop (didn't bet)
Seat 7: brens420 showed [Jc Ac] and lost with a pair of Aces
Seat 8: TheBigAceT folded before Flop (didn't bet)
Seat 9: moxiejan (button) folded before Flop (didn't bet)

*********** # 61 **************
PokerStars Game #136583488: Tournament #376033, Hold'em Limit - Level VI (200/400) - 2003/10/05 - 01:22:01 (ET)
Table '376033 3' Seat #1 is the button
Seat 1: Starstealer (7830 in chips) 
Seat 2: AnneK919 (1785 in chips) 
Seat 3: witchypoo (1171 in chips) 
Seat 4: KyDeano (1540 in chips) 
Seat 5: bluesteele (12715 in chips) 
Seat 6: aeneas23 (2865 in chips) 
Seat 8: TheBigAceT (1195 in chips) 
Seat 9: moxiejan (1875 in chips) 
AnneK919: posts small blind 100
witchypoo: posts big blind 200
*** HOLE CARDS ***
Dealt to Starstealer [9h 8h]
KyDeano: folds 
bluesteele: calls 200
aeneas23: folds 
TheBigAceT: folds 
moxiejan: raises 200 to 400
Starstealer: folds 
AnneK919: folds 
witchypoo: folds 
bluesteele: calls 200
*** FLOP *** [Jc Qs 6h]
bluesteele: bets 200
moxiejan: calls 200
*** TURN *** [Jc Qs 6h] [Js]
bluesteele: bets 400
moxiejan: calls 400
*** RIVER *** [Jc Qs 6h Js] [Qh]
bluesteele: bets 400
moxiejan: calls 400
*** SHOW DOWN ***
bluesteele: shows [Ad 6d] (two pair, Queens and Jacks)
moxiejan: shows [Ks Ac] (two pair, Queens and Jacks)
bluesteele collected 1550 from  pot
moxiejan collected 1550 from  pot
*** SUMMARY ***
Total pot 3100 | Rake 0 
Board [Jc Qs 6h Js Qh]
Seat 1: Starstealer (button) folded before Flop (didn't bet)
Seat 2: AnneK919 (small blind) folded before Flop
Seat 3: witchypoo (big blind) folded before Flop
Seat 4: KyDeano folded before Flop (didn't bet)
Seat 5: bluesteele showed [Ad 6d] and won (1550) with two pair, Queens and Jacks
Seat 6: aeneas23 folded before Flop (didn't bet)
Seat 8: TheBigAceT folded before Flop (didn't bet)
Seat 9: moxiejan showed [Ks Ac] and won (1550) with two pair, Queens and Jacks

*********** # 62 **************
PokerStars Game #136584354: Tournament #376033, Hold'em Limit - Level VI (200/400) - 2003/10/05 - 01:23:03 (ET)
Table '376033 3' Seat #2 is the button
Seat 1: Starstealer (7830 in chips) 
Seat 2: AnneK919 (1685 in chips) 
Seat 3: witchypoo (971 in chips) 
Seat 4: KyDeano (1540 in chips) 
Seat 5: bluesteele (12865 in chips) 
Seat 6: aeneas23 (2865 in chips) 
Seat 8: TheBigAceT (1195 in chips) 
Seat 9: moxiejan (2025 in chips) 
witchypoo: posts small blind 100
KyDeano: posts big blind 200
*** HOLE CARDS ***
Dealt to Starstealer [7d Ts]
bluesteele: calls 200
aeneas23: calls 200
TheBigAceT: folds 
moxiejan: calls 200
Chula*Del is connected 
Starstealer: folds 
AnneK919: folds 
witchypoo: calls 100
KyDeano: checks 
*** FLOP *** [Th 5s Qc]
witchypoo: checks 
KyDeano: checks 
bluesteele: bets 200
aeneas23: calls 200
moxiejan: folds 
witchypoo: folds 
KyDeano: folds 
*** TURN *** [Th 5s Qc] [4d]
bluesteele: bets 400
aeneas23: calls 400
*** RIVER *** [Th 5s Qc 4d] [Tc]
bluesteele: bets 400
aeneas23: calls 400
*** SHOW DOWN ***
bluesteele: shows [Ad Ac] (two pair, Aces and Tens)
aeneas23: mucks hand 
bluesteele collected 3000 from  pot
*** SUMMARY ***
Total pot 3000 | Rake 0 
Board [Th 5s Qc 4d Tc]
Seat 1: Starstealer folded before Flop (didn't bet)
Seat 2: AnneK919 (button) folded before Flop (didn't bet)
Seat 3: witchypoo (small blind) folded on the Flop
Seat 4: KyDeano (big blind) folded on the Flop
Seat 5: bluesteele showed [Ad Ac] and won (3000) with two pair, Aces and Tens
Seat 6: aeneas23 mucked [Jd Qs] - two pair, Queens and Tens
Seat 8: TheBigAceT folded before Flop (didn't bet)
Seat 9: moxiejan folded on the Flop

*********** # 63 **************
PokerStars Game #136585291: Tournament #376033, Hold'em Limit - Level VI (200/400) - 2003/10/05 - 01:24:09 (ET)
Table '376033 3' Seat #3 is the button
Seat 1: Starstealer (7830 in chips) 
Seat 2: AnneK919 (1685 in chips) 
Seat 3: witchypoo (771 in chips) 
Seat 4: KyDeano (1340 in chips) 
Seat 5: bluesteele (14665 in chips) 
Seat 6: aeneas23 (1665 in chips) 
Seat 7: Chula*Del (3905 in chips) 
Seat 8: TheBigAceT (1195 in chips) 
Seat 9: moxiejan (1825 in chips) 
KyDeano: posts small blind 100
bluesteele: posts big blind 200
*** HOLE CARDS ***
Dealt to Starstealer [4c Qd]
aeneas23: folds 
Chula*Del: folds 
TheBigAceT: folds 
moxiejan: raises 200 to 400
Starstealer: folds 
AnneK919: folds 
witchypoo: folds 
KyDeano: folds 
bluesteele: calls 200
*** FLOP *** [Jh 6c 6s]
bluesteele: checks 
moxiejan: bets 200
bluesteele: folds 
moxiejan collected 900 from  pot
moxiejan: doesn't show hand 
*** SUMMARY ***
Total pot 900 | Rake 0 
Board [Jh 6c 6s]
Seat 1: Starstealer folded before Flop (didn't bet)
Seat 2: AnneK919 folded before Flop (didn't bet)
Seat 3: witchypoo (button) folded before Flop (didn't bet)
Seat 4: KyDeano (small blind) folded before Flop
Seat 5: bluesteele (big blind) folded on the Flop
Seat 6: aeneas23 folded before Flop (didn't bet)
Seat 7: Chula*Del folded before Flop (didn't bet)
Seat 8: TheBigAceT folded before Flop (didn't bet)
Seat 9: moxiejan collected (900)

*********** # 64 **************
PokerStars Game #136585759: Tournament #376033, Hold'em Limit - Level VI (200/400) - 2003/10/05 - 01:24:44 (ET)
Table '376033 3' Seat #4 is the button
Seat 1: Starstealer (7830 in chips) 
Seat 2: AnneK919 (1685 in chips) 
Seat 3: witchypoo (771 in chips) 
Seat 4: KyDeano (1240 in chips) 
Seat 5: bluesteele (14265 in chips) 
Seat 6: aeneas23 (1665 in chips) 
Seat 7: Chula*Del (3905 in chips) 
Seat 8: TheBigAceT (1195 in chips) 
Seat 9: moxiejan (2325 in chips) 
bluesteele: posts small blind 100
aeneas23: posts big blind 200
*** HOLE CARDS ***
Dealt to Starstealer [2c 7d]
Chula*Del: calls 200
TheBigAceT: folds 
moxiejan: folds 
Starstealer: folds 
AnneK919: folds 
witchypoo: folds 
KyDeano: folds 
bluesteele: calls 100
aeneas23: checks 
*** FLOP *** [Qc 9d 9s]
bluesteele: bets 200
aeneas23: calls 200
Chula*Del: calls 200
*** TURN *** [Qc 9d 9s] [5d]
bluesteele: bets 400
aeneas23: calls 400
Chula*Del: folds 
*** RIVER *** [Qc 9d 9s 5d] [Ts]
bluesteele: bets 400
aeneas23: calls 400
*** SHOW DOWN ***
bluesteele: shows [2d Qd] (two pair, Queens and Nines)
aeneas23: shows [4s Qs] (two pair, Queens and Nines)
bluesteele collected 1400 from  pot
aeneas23 collected 1400 from  pot
*** SUMMARY ***
Total pot 2800 | Rake 0 
Board [Qc 9d 9s 5d Ts]
Seat 1: Starstealer folded before Flop (didn't bet)
Seat 2: AnneK919 folded before Flop (didn't bet)
Seat 3: witchypoo folded before Flop (didn't bet)
Seat 4: KyDeano (button) folded before Flop (didn't bet)
Seat 5: bluesteele (small blind) showed [2d Qd] and won (1400) with two pair, Queens and Nines
Seat 6: aeneas23 (big blind) showed [4s Qs] and won (1400) with two pair, Queens and Nines
Seat 7: Chula*Del folded on the Turn
Seat 8: TheBigAceT folded before Flop (didn't bet)
Seat 9: moxiejan folded before Flop (didn't bet)

*********** # 65 **************
PokerStars Game #136586506: Tournament #376033, Hold'em Limit - Level VI (200/400) - 2003/10/05 - 01:25:36 (ET)
Table '376033 3' Seat #5 is the button
Seat 1: Starstealer (7830 in chips) 
Seat 2: AnneK919 (1685 in chips) 
Seat 3: witchypoo (771 in chips) 
Seat 4: KyDeano (1240 in chips) 
Seat 5: bluesteele (14465 in chips) 
Seat 6: aeneas23 (1865 in chips) 
Seat 7: Chula*Del (3505 in chips) 
Seat 8: TheBigAceT (1195 in chips) 
Seat 9: moxiejan (2325 in chips) 
aeneas23: posts small blind 100
Chula*Del: posts big blind 200
*** HOLE CARDS ***
Dealt to Starstealer [Jd 3s]
TheBigAceT: folds 
moxiejan: folds 
Starstealer: folds 
AnneK919: folds 
witchypoo: folds 
KyDeano: calls 200
bluesteele: folds 
aeneas23: calls 100
Chula*Del: checks 
*** FLOP *** [Kc 4h Jh]
aeneas23: bets 200
Chula*Del: folds 
KyDeano: raises 200 to 400
aeneas23: calls 200
*** TURN *** [Kc 4h Jh] [6h]
aeneas23: bets 400
KyDeano: calls 400
*** RIVER *** [Kc 4h Jh 6h] [2s]
aeneas23: bets 400
KyDeano: calls 240 and is all-in
*** SHOW DOWN ***
aeneas23: shows [7h Ah] (a flush, Ace high)
KyDeano: shows [Ks 8d] (a pair of Kings)
aeneas23 collected 2680 from  pot
*** SUMMARY ***
Total pot 2680 | Rake 0 
Board [Kc 4h Jh 6h 2s]
Seat 1: Starstealer folded before Flop (didn't bet)
Seat 2: AnneK919 folded before Flop (didn't bet)
Seat 3: witchypoo folded before Flop (didn't bet)
Seat 4: KyDeano showed [Ks 8d] and lost with a pair of Kings
Seat 5: bluesteele (button) folded before Flop (didn't bet)
Seat 6: aeneas23 (small blind) showed [7h Ah] and won (2680) with a flush, Ace high
Seat 7: Chula*Del (big blind) folded on the Flop
Seat 8: TheBigAceT folded before Flop (didn't bet)
Seat 9: moxiejan folded before Flop (didn't bet)

*********** # 66 **************
PokerStars Game #136587192: Tournament #376033, Hold'em Limit - Level VI (200/400) - 2003/10/05 - 01:26:26 (ET)
Table '376033 3' Seat #6 is the button
Seat 1: Starstealer (7830 in chips) 
Seat 2: AnneK919 (1685 in chips) 
Seat 3: witchypoo (771 in chips) 
Seat 5: bluesteele (14465 in chips) 
Seat 6: aeneas23 (3305 in chips) 
Seat 7: Chula*Del (3305 in chips) 
Seat 8: TheBigAceT (1195 in chips) 
Seat 9: moxiejan (2325 in chips) 
Chula*Del: posts small blind 100
TheBigAceT: posts big blind 200
*** HOLE CARDS ***
Dealt to Starstealer [As 8d]
moxiejan: folds 
Starstealer: folds 
AnneK919: folds 
witchypoo: raises 200 to 400
bluesteele: calls 400
aeneas23: folds 
Chula*Del: folds 
TheBigAceT: folds 
*** FLOP *** [Ks 3s 2s]
witchypoo: bets 200
bluesteele: calls 200
*** TURN *** [Ks 3s 2s] [7s]
witchypoo: checks 
bluesteele: bets 400
witchypoo: folds 
bluesteele collected 1500 from  pot
bluesteele: doesn't show hand 
*** SUMMARY ***
Total pot 1500 | Rake 0 
Board [Ks 3s 2s 7s]
Seat 1: Starstealer folded before Flop (didn't bet)
Seat 2: AnneK919 folded before Flop (didn't bet)
Seat 3: witchypoo folded on the Turn
Seat 5: bluesteele collected (1500)
Seat 6: aeneas23 (button) folded before Flop (didn't bet)
Seat 7: Chula*Del (small blind) folded before Flop
Seat 8: TheBigAceT (big blind) folded before Flop
Seat 9: moxiejan folded before Flop (didn't bet)

*********** # 67 **************
PokerStars Game #136587776: Tournament #376033, Hold'em Limit - Level VI (200/400) - 2003/10/05 - 01:27:08 (ET)
Table '376033 3' Seat #7 is the button
Seat 1: Starstealer (7830 in chips) 
Seat 2: AnneK919 (1685 in chips) 
Seat 3: witchypoo (171 in chips) 
Seat 5: bluesteele (15365 in chips) 
Seat 6: aeneas23 (3305 in chips) 
Seat 7: Chula*Del (3205 in chips) 
Seat 8: TheBigAceT (995 in chips) 
Seat 9: moxiejan (2325 in chips) 
TheBigAceT: posts small blind 100
moxiejan: posts big blind 200
*** HOLE CARDS ***
Dealt to Starstealer [8c 3h]
Starstealer: folds 
AnneK919: folds 
witchypoo: folds 
bluesteele: folds 
aeneas23: folds 
Chula*Del: folds 
TheBigAceT: raises 200 to 400
moxiejan: raises 200 to 600
TheBigAceT: calls 200
*** FLOP *** [2h 8d 7d]
TheBigAceT: bets 200
moxiejan: raises 200 to 400
TheBigAceT: calls 195 and is all-in
*** TURN *** [2h 8d 7d] [Ah]
*** RIVER *** [2h 8d 7d Ah] [Jh]
*** SHOW DOWN ***
TheBigAceT: shows [9h Ac] (a pair of Aces)
moxiejan: shows [Ks Kh] (a pair of Kings)
TheBigAceT collected 1990 from  pot
*** SUMMARY ***
Total pot 1990 | Rake 0 
Board [2h 8d 7d Ah Jh]
Seat 1: Starstealer folded before Flop (didn't bet)
Seat 2: AnneK919 folded before Flop (didn't bet)
Seat 3: witchypoo folded before Flop (didn't bet)
Seat 5: bluesteele folded before Flop (didn't bet)
Seat 6: aeneas23 folded before Flop (didn't bet)
Seat 7: Chula*Del (button) folded before Flop (didn't bet)
Seat 8: TheBigAceT (small blind) showed [9h Ac] and won (1990) with a pair of Aces
Seat 9: moxiejan (big blind) showed [Ks Kh] and lost with a pair of Kings

*********** # 68 **************
PokerStars Game #136588349: Tournament #376033, Hold'em Limit - Level VI (200/400) - 2003/10/05 - 01:27:50 (ET)
Table '376033 3' Seat #8 is the button
Seat 1: Starstealer (7830 in chips) 
Seat 2: AnneK919 (1685 in chips) 
Seat 3: witchypoo (171 in chips) 
Seat 5: bluesteele (15365 in chips) 
Seat 6: aeneas23 (3305 in chips) 
Seat 7: Chula*Del (3205 in chips) 
Seat 8: TheBigAceT (1990 in chips) 
Seat 9: moxiejan (1330 in chips) 
moxiejan: posts small blind 100
Starstealer: posts big blind 200
*** HOLE CARDS ***
Dealt to Starstealer [9d 6s]
AnneK919: folds 
witchypoo: calls 171 and is all-in
bluesteele: folds 
ralph roe is connected 
aeneas23: calls 200
Chula*Del: folds 
TheBigAceT: folds 
moxiejan: folds 
Starstealer: checks 
*** FLOP *** [Jh 6h 9c]
Starstealer: bets 200
aeneas23: calls 200
*** TURN *** [Jh 6h 9c] [5c]
Starstealer: bets 400
aeneas23: calls 400
*** RIVER *** [Jh 6h 9c 5c] [Ah]
Starstealer: checks 
aeneas23: bets 400
Starstealer: calls 400
*** SHOW DOWN ***
aeneas23: shows [Kh 2h] (a flush, Ace high)
Starstealer: mucks hand 
aeneas23 collected 2058 from side pot
witchypoo: mucks hand 
aeneas23 collected 613 from main pot
*** SUMMARY ***
Total pot 2671 Main pot 613. Side pot 2058. | Rake 0 
Board [Jh 6h 9c 5c Ah]
Seat 1: Starstealer (big blind) mucked [9d 6s] - two pair, Nines and Sixes
Seat 2: AnneK919 folded before Flop (didn't bet)
Seat 3: witchypoo mucked [Th Qd] - high card Ace
Seat 5: bluesteele folded before Flop (didn't bet)
Seat 6: aeneas23 showed [Kh 2h] and won (2671) with a flush, Ace high
Seat 7: Chula*Del folded before Flop (didn't bet)
Seat 8: TheBigAceT (button) folded before Flop (didn't bet)
Seat 9: moxiejan (small blind) folded before Flop

*********** # 69 **************
PokerStars Game #136589317: Tournament #376033, Hold'em Limit - Level VI (200/400) - 2003/10/05 - 01:29:01 (ET)
Table '376033 3' Seat #9 is the button
Seat 1: Starstealer (6630 in chips) 
Seat 2: AnneK919 (1685 in chips) 
Seat 4: ralph roe (2830 in chips) 
Seat 5: bluesteele (15365 in chips) 
Seat 6: aeneas23 (4776 in chips) 
Seat 7: Chula*Del (3205 in chips) 
Seat 8: TheBigAceT (1990 in chips) 
Seat 9: moxiejan (1230 in chips) 
Starstealer: posts small blind 100
AnneK919: posts big blind 200
*** HOLE CARDS ***
Dealt to Starstealer [6c Jd]
ralph roe: folds 
bluesteele: folds 
aeneas23: calls 200
Chula*Del: folds 
TheBigAceT: folds 
moxiejan: folds 
Starstealer: folds 
AnneK919: checks 
*** FLOP *** [7h Td 3c]
AnneK919: checks 
aeneas23: bets 200
AnneK919: calls 200
*** TURN *** [7h Td 3c] [Ts]
AnneK919: checks 
aeneas23: bets 400
AnneK919: folds 
aeneas23 collected 900 from  pot
aeneas23: doesn't show hand 
*** SUMMARY ***
Total pot 900 | Rake 0 
Board [7h Td 3c Ts]
Seat 1: Starstealer (small blind) folded before Flop
Seat 2: AnneK919 (big blind) folded on the Turn
Seat 4: ralph roe folded before Flop (didn't bet)
Seat 5: bluesteele folded before Flop (didn't bet)
Seat 6: aeneas23 collected (900)
Seat 7: Chula*Del folded before Flop (didn't bet)
Seat 8: TheBigAceT folded before Flop (didn't bet)
Seat 9: moxiejan (button) folded before Flop (didn't bet)

*********** # 70 **************
PokerStars Game #136589918: Tournament #376033, Hold'em Limit - Level VI (200/400) - 2003/10/05 - 01:29:45 (ET)
Table '376033 3' Seat #1 is the button
Seat 1: Starstealer (6530 in chips) 
Seat 2: AnneK919 (1285 in chips) 
Seat 4: ralph roe (2830 in chips) 
Seat 5: bluesteele (15365 in chips) 
Seat 6: aeneas23 (5276 in chips) 
Seat 7: Chula*Del (3205 in chips) 
Seat 8: TheBigAceT (1990 in chips) 
Seat 9: moxiejan (1230 in chips) 
AnneK919: posts small blind 100
ralph roe: posts big blind 200
*** HOLE CARDS ***
Dealt to Starstealer [4c Kc]
u_s_eh is connected 
bluesteele: folds 
aeneas23: calls 200
Chula*Del: folds 
TheBigAceT: folds 
moxiejan: folds 
Starstealer: folds 
AnneK919: calls 100
ralph roe: checks 
*** FLOP *** [Tc Jc 4d]
AnneK919: checks 
ralph roe: checks 
aeneas23: bets 200
AnneK919: folds 
ralph roe: folds 
aeneas23 collected 600 from  pot
aeneas23: doesn't show hand 
*** SUMMARY ***
Total pot 600 | Rake 0 
Board [Tc Jc 4d]
Seat 1: Starstealer (button) folded before Flop (didn't bet)
Seat 2: AnneK919 (small blind) folded on the Flop
Seat 4: ralph roe (big blind) folded on the Flop
Seat 5: bluesteele folded before Flop (didn't bet)
Seat 6: aeneas23 collected (600)
Seat 7: Chula*Del folded before Flop (didn't bet)
Seat 8: TheBigAceT folded before Flop (didn't bet)
Seat 9: moxiejan folded before Flop (didn't bet)

*********** # 71 **************
PokerStars Game #136590591: Tournament #376033, Hold'em Limit - Level VI (200/400) - 2003/10/05 - 01:30:33 (ET)
Table '376033 3' Seat #2 is the button
Seat 1: Starstealer (6530 in chips) 
Seat 2: AnneK919 (1085 in chips) 
Seat 3: u_s_eh (1760 in chips) out of hand (moved from another table into small blind)
Seat 4: ralph roe (2630 in chips) 
Seat 5: bluesteele (15365 in chips) 
Seat 6: aeneas23 (5676 in chips) 
Seat 7: Chula*Del (3205 in chips) 
Seat 8: TheBigAceT (1990 in chips) 
Seat 9: moxiejan (1230 in chips) 
ralph roe: posts small blind 100
bluesteele: posts big blind 200
*** HOLE CARDS ***
Dealt to Starstealer [Qc Jd]
aeneas23: folds 
Chula*Del: folds 
TheBigAceT: folds 
moxiejan: folds 
Starstealer: folds 
AnneK919: folds 
ralph roe: folds 
bluesteele collected 200 from  pot
bluesteele: doesn't show hand 
*** SUMMARY ***
Total pot 200 | Rake 0 
Seat 1: Starstealer folded before Flop (didn't bet)
Seat 2: AnneK919 (button) folded before Flop (didn't bet)
Seat 4: ralph roe (small blind) folded before Flop
Seat 5: bluesteele (big blind) collected (200)
Seat 6: aeneas23 folded before Flop (didn't bet)
Seat 7: Chula*Del folded before Flop (didn't bet)
Seat 8: TheBigAceT folded before Flop (didn't bet)
Seat 9: moxiejan folded before Flop (didn't bet)

*********** # 72 **************
PokerStars Game #136590925: Tournament #376033, Hold'em Limit - Level VI (200/400) - 2003/10/05 - 01:30:58 (ET)
Table '376033 3' Seat #4 is the button
Seat 1: Starstealer (6530 in chips) 
Seat 2: AnneK919 (1085 in chips) 
Seat 3: u_s_eh (1760 in chips) 
Seat 4: ralph roe (2530 in chips) 
Seat 5: bluesteele (15465 in chips) 
Seat 6: aeneas23 (5676 in chips) 
Seat 7: Chula*Del (3205 in chips) 
Seat 8: TheBigAceT (1990 in chips) 
Seat 9: moxiejan (1230 in chips) 
bluesteele: posts small blind 100
aeneas23: posts big blind 200
*** HOLE CARDS ***
Dealt to Starstealer [3d 3s]
Chula*Del: folds 
TheBigAceT: folds 
moxiejan: folds 
Starstealer: raises 200 to 400
AnneK919: calls 400
u_s_eh: folds 
ralph roe: folds 
bluesteele: calls 300
aeneas23: folds 
*** FLOP *** [Jh Qs 2h]
bluesteele: bets 200
Starstealer: folds 
AnneK919: calls 200
*** TURN *** [Jh Qs 2h] [5h]
bluesteele: checks 
AnneK919: bets 400
bluesteele: calls 400
*** RIVER *** [Jh Qs 2h 5h] [Qd]
bluesteele: checks 
AnneK919: checks 
*** SHOW DOWN ***
bluesteele: shows [Kd 2d] (two pair, Queens and Deuces)
AnneK919: mucks hand 
bluesteele collected 2600 from  pot
*** SUMMARY ***
Total pot 2600 | Rake 0 
Board [Jh Qs 2h 5h Qd]
Seat 1: Starstealer folded on the Flop
Seat 2: AnneK919 mucked [6c Ac] - a pair of Queens
Seat 3: u_s_eh folded before Flop (didn't bet)
Seat 4: ralph roe (button) folded before Flop (didn't bet)
Seat 5: bluesteele (small blind) showed [Kd 2d] and won (2600) with two pair, Queens and Deuces
Seat 6: aeneas23 (big blind) folded before Flop
Seat 7: Chula*Del folded before Flop (didn't bet)
Seat 8: TheBigAceT folded before Flop (didn't bet)
Seat 9: moxiejan folded before Flop (didn't bet)

*********** # 73 **************
PokerStars Game #136591902: Tournament #376033, Hold'em Limit - Level VI (200/400) - 2003/10/05 - 01:32:09 (ET)
Table '376033 3' Seat #5 is the button
Seat 1: Starstealer (6130 in chips) 
Seat 2: AnneK919 (85 in chips) 
Seat 3: u_s_eh (1760 in chips) 
Seat 4: ralph roe (2530 in chips) 
Seat 5: bluesteele (17065 in chips) 
Seat 6: aeneas23 (5476 in chips) 
Seat 7: Chula*Del (3205 in chips) 
Seat 8: TheBigAceT (1990 in chips) 
Seat 9: moxiejan (1230 in chips) 
aeneas23: posts small blind 100
Chula*Del: posts big blind 200
*** HOLE CARDS ***
Dealt to Starstealer [Kd 9c]
TheBigAceT: raises 200 to 400
moxiejan: folds 
Starstealer: folds 
AnneK919: calls 85 and is all-in
u_s_eh: folds 
ralph roe: folds 
bluesteele: folds 
aeneas23: folds 
Chula*Del: calls 200
*** FLOP *** [Td Ks Ah]
Chula*Del: checks 
TheBigAceT: bets 200
Chula*Del: calls 200
*** TURN *** [Td Ks Ah] [8d]
Chula*Del: checks 
TheBigAceT: bets 400
Chula*Del: calls 400
*** RIVER *** [Td Ks Ah 8d] [3d]
Chula*Del: checks 
TheBigAceT: bets 400
Chula*Del: calls 400
*** SHOW DOWN ***
TheBigAceT: shows [Ts As] (two pair, Aces and Tens)
Chula*Del: shows [Qh Qs] (a pair of Queens)
TheBigAceT collected 2645 from side pot
AnneK919: shows [Ac 6d] (a pair of Aces)
TheBigAceT collected 340 from main pot
*** SUMMARY ***
Total pot 2985 Main pot 340. Side pot 2645. | Rake 0 
Board [Td Ks Ah 8d 3d]
Seat 1: Starstealer folded before Flop (didn't bet)
Seat 2: AnneK919 showed [Ac 6d] and lost with a pair of Aces
Seat 3: u_s_eh folded before Flop (didn't bet)
Seat 4: ralph roe folded before Flop (didn't bet)
Seat 5: bluesteele (button) folded before Flop (didn't bet)
Seat 6: aeneas23 (small blind) folded before Flop
Seat 7: Chula*Del (big blind) showed [Qh Qs] and lost with a pair of Queens
Seat 8: TheBigAceT showed [Ts As] and won (2985) with two pair, Aces and Tens
Seat 9: moxiejan folded before Flop (didn't bet)

*********** # 74 **************
PokerStars Game #136592653: Tournament #376033, Hold'em Limit - Level VI (200/400) - 2003/10/05 - 01:33:03 (ET)
Table '376033 3' Seat #6 is the button
Seat 1: Starstealer (6130 in chips) 
Seat 3: u_s_eh (1760 in chips) 
Seat 4: ralph roe (2530 in chips) 
Seat 5: bluesteele (17065 in chips) 
Seat 6: aeneas23 (5376 in chips) 
Seat 7: Chula*Del (1805 in chips) 
Seat 8: TheBigAceT (3575 in chips) 
Seat 9: moxiejan (1230 in chips) 
Chula*Del: posts small blind 100
TheBigAceT: posts big blind 200
*** HOLE CARDS ***
Dealt to Starstealer [9s 7h]
moxiejan: folds 
Starstealer: folds 
u_s_eh: folds 
ralph roe: folds 
bluesteele: calls 200
aeneas23: folds 
Chula*Del: calls 100
TheBigAceT: checks 
*** FLOP *** [8c Kc Ks]
MrsConcrete is connected 
Chula*Del: checks 
TheBigAceT: checks 
bluesteele: bets 200
Chula*Del: folds 
TheBigAceT: folds 
bluesteele collected 600 from  pot
bluesteele: doesn't show hand 
*** SUMMARY ***
Total pot 600 | Rake 0 
Board [8c Kc Ks]
Seat 1: Starstealer folded before Flop (didn't bet)
Seat 3: u_s_eh folded before Flop (didn't bet)
Seat 4: ralph roe folded before Flop (didn't bet)
Seat 5: bluesteele collected (600)
Seat 6: aeneas23 (button) folded before Flop (didn't bet)
Seat 7: Chula*Del (small blind) folded on the Flop
Seat 8: TheBigAceT (big blind) folded on the Flop
Seat 9: moxiejan folded before Flop (didn't bet)

*********** # 75 **************
PokerStars Game #136593188: Tournament #376033, Hold'em Limit - Level VI (200/400) - 2003/10/05 - 01:33:43 (ET)
Table '376033 3' Seat #7 is the button
Seat 1: Starstealer (6130 in chips) 
Seat 2: MrsConcrete (5985 in chips) 
Seat 3: u_s_eh (1760 in chips) 
Seat 4: ralph roe (2530 in chips) 
Seat 5: bluesteele (17465 in chips) 
Seat 6: aeneas23 (5376 in chips) 
Seat 7: Chula*Del (1605 in chips) 
Seat 8: TheBigAceT (3375 in chips) 
Seat 9: moxiejan (1230 in chips) 
TheBigAceT: posts small blind 100
moxiejan: posts big blind 200
*** HOLE CARDS ***
Dealt to Starstealer [Qs Qc]
Starstealer: raises 200 to 400
MrsConcrete: folds 
u_s_eh: calls 400
ralph roe: folds 
bluesteele: folds 
aeneas23: folds 
Chula*Del: folds 
TheBigAceT: folds 
moxiejan: folds 
*** FLOP *** [7s 8d Ks]
Starstealer: bets 200
u_s_eh: folds 
Starstealer collected 1100 from  pot
Starstealer: doesn't show hand 
*** SUMMARY ***
Total pot 1100 | Rake 0 
Board [7s 8d Ks]
Seat 1: Starstealer collected (1100)
Seat 2: MrsConcrete folded before Flop (didn't bet)
Seat 3: u_s_eh folded on the Flop
Seat 4: ralph roe folded before Flop (didn't bet)
Seat 5: bluesteele folded before Flop (didn't bet)
Seat 6: aeneas23 folded before Flop (didn't bet)
Seat 7: Chula*Del (button) folded before Flop (didn't bet)
Seat 8: TheBigAceT (small blind) folded before Flop
Seat 9: moxiejan (big blind) folded before Flop

*********** # 76 **************
PokerStars Game #136593877: Tournament #376033, Hold'em Limit - Level VI (200/400) - 2003/10/05 - 01:34:33 (ET)
Table '376033 3' Seat #8 is the button
Seat 1: Starstealer (6830 in chips) 
Seat 2: MrsConcrete (5985 in chips) 
Seat 3: u_s_eh (1360 in chips) 
Seat 4: ralph roe (2530 in chips) 
Seat 5: bluesteele (17465 in chips) 
Seat 6: aeneas23 (5376 in chips) 
Seat 7: Chula*Del (1605 in chips) 
Seat 8: TheBigAceT (3275 in chips) 
Seat 9: moxiejan (1030 in chips) 
moxiejan: posts small blind 100
Starstealer: posts big blind 200
*** HOLE CARDS ***
Dealt to Starstealer [3h Ks]
MrsConcrete: folds 
u_s_eh: raises 200 to 400
ralph roe: folds 
bluesteele: folds 
aeneas23: folds 
Chula*Del: calls 400
TheBigAceT: folds 
moxiejan: calls 300
Starstealer: folds 
*** FLOP *** [Ah 9d 7c]
moxiejan: checks 
u_s_eh: bets 200
Chula*Del: calls 200
moxiejan: folds 
*** TURN *** [Ah 9d 7c] [4h]
u_s_eh: bets 400
Chula*Del: calls 400
*** RIVER *** [Ah 9d 7c 4h] [6s]
u_s_eh: bets 360 and is all-in
Chula*Del: calls 360
*** SHOW DOWN ***
u_s_eh: shows [As Qd] (a pair of Aces)
Chula*Del: shows [Ac 2s] (a pair of Aces - lower kicker)
u_s_eh collected 3320 from  pot
*** SUMMARY ***
Total pot 3320 | Rake 0 
Board [Ah 9d 7c 4h 6s]
Seat 1: Starstealer (big blind) folded before Flop
Seat 2: MrsConcrete folded before Flop (didn't bet)
Seat 3: u_s_eh showed [As Qd] and won (3320) with a pair of Aces
Seat 4: ralph roe folded before Flop (didn't bet)
Seat 5: bluesteele folded before Flop (didn't bet)
Seat 6: aeneas23 folded before Flop (didn't bet)
Seat 7: Chula*Del showed [Ac 2s] and lost with a pair of Aces
Seat 8: TheBigAceT (button) folded before Flop (didn't bet)
Seat 9: moxiejan (small blind) folded on the Flop

*********** # 77 **************
PokerStars Game #136594611: Tournament #376033, Hold'em Limit - Level VI (200/400) - 2003/10/05 - 01:35:29 (ET)
Table '376033 3' Seat #9 is the button
Seat 1: Starstealer (6630 in chips) 
Seat 2: MrsConcrete (5985 in chips) 
Seat 3: u_s_eh (3320 in chips) 
Seat 4: ralph roe (2530 in chips) 
Seat 5: bluesteele (17465 in chips) 
Seat 6: aeneas23 (5376 in chips) 
Seat 7: Chula*Del (245 in chips) 
Seat 8: TheBigAceT (3275 in chips) 
Seat 9: moxiejan (630 in chips) 
Starstealer: posts small blind 100
MrsConcrete: posts big blind 200
*** HOLE CARDS ***
Dealt to Starstealer [9c 2d]
u_s_eh: folds 
ralph roe: raises 200 to 400
bluesteele: calls 400
aeneas23: folds 
Chula*Del: folds 
TheBigAceT: calls 400
moxiejan: folds 
Starstealer: folds 
MrsConcrete: folds 
*** FLOP *** [5c 4d Ad]
ralph roe: checks 
bluesteele: bets 200
TheBigAceT: raises 200 to 400
ralph roe: folds 
bluesteele: calls 200
*** TURN *** [5c 4d Ad] [3d]
bluesteele: checks 
TheBigAceT: checks 
*** RIVER *** [5c 4d Ad 3d] [2c]
bluesteele: checks 
TheBigAceT: checks 
*** SHOW DOWN ***
bluesteele: shows [Ks 9s] (a straight, Ace to Five)
TheBigAceT: shows [Kc As] (a straight, Ace to Five)
bluesteele collected 1150 from  pot
TheBigAceT collected 1150 from  pot
*** SUMMARY ***
Total pot 2300 | Rake 0 
Board [5c 4d Ad 3d 2c]
Seat 1: Starstealer (small blind) folded before Flop
Seat 2: MrsConcrete (big blind) folded before Flop
Seat 3: u_s_eh folded before Flop (didn't bet)
Seat 4: ralph roe folded on the Flop
Seat 5: bluesteele showed [Ks 9s] and won (1150) with a straight, Ace to Five
Seat 6: aeneas23 folded before Flop (didn't bet)
Seat 7: Chula*Del folded before Flop (didn't bet)
Seat 8: TheBigAceT showed [Kc As] and won (1150) with a straight, Ace to Five
Seat 9: moxiejan (button) folded before Flop (didn't bet)

*********** # 78 **************
PokerStars Game #136595474: Tournament #376033, Hold'em Limit - Level VII (300/600) - 2003/10/05 - 01:36:33 (ET)
Table '376033 3' Seat #1 is the button
Seat 1: Starstealer (6530 in chips) 
Seat 2: MrsConcrete (5785 in chips) 
Seat 3: u_s_eh (3320 in chips) 
Seat 4: ralph roe (2130 in chips) 
Seat 5: bluesteele (17815 in chips) 
Seat 6: aeneas23 (5376 in chips) 
Seat 7: Chula*Del (245 in chips) 
Seat 8: TheBigAceT (3625 in chips) 
Seat 9: moxiejan (630 in chips) 
MrsConcrete: posts small blind 150
u_s_eh: posts big blind 300
*** HOLE CARDS ***
Dealt to Starstealer [Qd 4d]
ralph roe: folds 
bluesteele: calls 300
aeneas23: folds 
Chula*Del: calls 245 and is all-in
TheBigAceT: folds 
moxiejan: folds 
Starstealer: folds 
MrsConcrete: folds 
u_s_eh: checks 
*** FLOP *** [Th 8c 3c]
u_s_eh: checks 
bluesteele: bets 300
u_s_eh: folds 
*** TURN *** [Th 8c 3c] [2c]
*** RIVER *** [Th 8c 3c 2c] [4s]
*** SHOW DOWN ***
bluesteele: shows [8s Ts] (two pair, Tens and Eights)
bluesteele collected 110 from side pot
Chula*Del: shows [2h Ac] (a pair of Deuces)
bluesteele collected 885 from main pot
*** SUMMARY ***
Total pot 995 Main pot 885. Side pot 110. | Rake 0 
Board [Th 8c 3c 2c 4s]
Seat 1: Starstealer (button) folded before Flop (didn't bet)
Seat 2: MrsConcrete (small blind) folded before Flop
Seat 3: u_s_eh (big blind) folded on the Flop
Seat 4: ralph roe folded before Flop (didn't bet)
Seat 5: bluesteele showed [8s Ts] and won (995) with two pair, Tens and Eights
Seat 6: aeneas23 folded before Flop (didn't bet)
Seat 7: Chula*Del showed [2h Ac] and lost with a pair of Deuces
Seat 8: TheBigAceT folded before Flop (didn't bet)
Seat 9: moxiejan folded before Flop (didn't bet)

*********** # 79 **************
PokerStars Game #136596109: Tournament #376033, Hold'em Limit - Level VII (300/600) - 2003/10/05 - 01:37:21 (ET)
Table '376033 3' Seat #2 is the button
Seat 1: Starstealer (6530 in chips) 
Seat 2: MrsConcrete (5635 in chips) 
Seat 3: u_s_eh (3020 in chips) 
Seat 4: ralph roe (2130 in chips) 
Seat 5: bluesteele (18510 in chips) 
Seat 6: aeneas23 (5376 in chips) 
Seat 8: TheBigAceT (3625 in chips) 
Seat 9: moxiejan (630 in chips) 
u_s_eh: posts small blind 150
ralph roe: posts big blind 300
*** HOLE CARDS ***
Dealt to Starstealer [Ac Ad]
bluesteele: calls 300
aeneas23: folds 
TheBigAceT: folds 
moxiejan: folds 
Starstealer: raises 300 to 600
MrsConcrete: folds 
u_s_eh: calls 450
ralph roe: folds 
bluesteele: calls 300
*** FLOP *** [4c Th 4d]
u_s_eh: checks 
bluesteele: checks 
Starstealer: bets 300
u_s_eh: folds 
bluesteele: calls 300
*** TURN *** [4c Th 4d] [6s]
bluesteele: checks 
Starstealer: bets 600
bluesteele: calls 600
*** RIVER *** [4c Th 4d 6s] [5h]
bluesteele: checks 
Starstealer: bets 600
SweetCharity is connected 
bluesteele: calls 600
*** SHOW DOWN ***
Starstealer: shows [Ac Ad] (two pair, Aces and Fours)
bluesteele: mucks hand 
Starstealer collected 5100 from  pot
*** SUMMARY ***
Total pot 5100 | Rake 0 
Board [4c Th 4d 6s 5h]
Seat 1: Starstealer showed [Ac Ad] and won (5100) with two pair, Aces and Fours
Seat 2: MrsConcrete (button) folded before Flop (didn't bet)
Seat 3: u_s_eh (small blind) folded on the Flop
Seat 4: ralph roe (big blind) folded before Flop
Seat 5: bluesteele mucked [5s Kc] - two pair, Fives and Fours
Seat 6: aeneas23 folded before Flop (didn't bet)
Seat 8: TheBigAceT folded before Flop (didn't bet)
Seat 9: moxiejan folded before Flop (didn't bet)

*********** # 80 **************
PokerStars Game #136597024: Tournament #376033, Hold'em Limit - Level VII (300/600) - 2003/10/05 - 01:38:33 (ET)
Table '376033 3' Seat #3 is the button
Seat 1: Starstealer (9530 in chips) 
Seat 2: MrsConcrete (5635 in chips) 
Seat 3: u_s_eh (2420 in chips) 
Seat 4: ralph roe (1830 in chips) 
Seat 5: bluesteele (16410 in chips) 
Seat 6: aeneas23 (5376 in chips) 
Seat 7: SweetCharity (5880 in chips) 
Seat 8: TheBigAceT (3625 in chips) 
Seat 9: moxiejan (630 in chips) 
ralph roe: posts small blind 150
bluesteele: posts big blind 300
*** HOLE CARDS ***
Dealt to Starstealer [Js 8c]
aeneas23: calls 300
SweetCharity: folds 
TheBigAceT: folds 
moxiejan: folds 
Starstealer: folds 
MrsConcrete: folds 
u_s_eh: folds 
ralph roe: calls 150
bluesteele: checks 
*** FLOP *** [8d 5c 9s]
ralph roe: bets 300
bluesteele: calls 300
aeneas23: raises 300 to 600
ralph roe: calls 300
bluesteele: calls 300
*** TURN *** [8d 5c 9s] [Jh]
ralph roe: checks 
bluesteele: checks 
aeneas23: bets 600
ralph roe: raises 330 to 930 and is all-in
bluesteele: folds 
aeneas23: calls 330
*** RIVER *** [8d 5c 9s Jh] [Ks]
*** SHOW DOWN ***
ralph roe: shows [Td Qh] (a straight, Nine to King)
aeneas23: shows [Qd Qs] (a pair of Queens)
ralph roe collected 4560 from  pot
*** SUMMARY ***
Total pot 4560 | Rake 0 
Board [8d 5c 9s Jh Ks]
Seat 1: Starstealer folded before Flop (didn't bet)
Seat 2: MrsConcrete folded before Flop (didn't bet)
Seat 3: u_s_eh (button) folded before Flop (didn't bet)
Seat 4: ralph roe (small blind) showed [Td Qh] and won (4560) with a straight, Nine to King
Seat 5: bluesteele (big blind) folded on the Turn
Seat 6: aeneas23 showed [Qd Qs] and lost with a pair of Queens
Seat 7: SweetCharity folded before Flop (didn't bet)
Seat 8: TheBigAceT folded before Flop (didn't bet)
Seat 9: moxiejan folded before Flop (didn't bet)

*********** # 81 **************
PokerStars Game #136598103: Tournament #376033, Hold'em Limit - Level VII (300/600) - 2003/10/05 - 01:39:57 (ET)
Table '376033 3' Seat #4 is the button
Seat 1: Starstealer (9530 in chips) 
Seat 2: MrsConcrete (5635 in chips) 
Seat 3: u_s_eh (2420 in chips) 
Seat 4: ralph roe (4560 in chips) 
Seat 5: bluesteele (15510 in chips) 
Seat 6: aeneas23 (3546 in chips) 
Seat 7: SweetCharity (5880 in chips) 
Seat 8: TheBigAceT (3625 in chips) 
Seat 9: moxiejan (630 in chips) 
bluesteele: posts small blind 150
aeneas23: posts big blind 300
*** HOLE CARDS ***
Dealt to Starstealer [6d Js]
SweetCharity: folds 
TheBigAceT: folds 
moxiejan: folds 
Starstealer: folds 
MrsConcrete: raises 300 to 600
u_s_eh: folds 
ralph roe: folds 
bluesteele: folds 
aeneas23: folds 
MrsConcrete collected 750 from  pot
*** SUMMARY ***
Total pot 750 | Rake 0 
Seat 1: Starstealer folded before Flop (didn't bet)
Seat 2: MrsConcrete collected (750)
Seat 3: u_s_eh folded before Flop (didn't bet)
Seat 4: ralph roe (button) folded before Flop (didn't bet)
Seat 5: bluesteele (small blind) folded before Flop
Seat 6: aeneas23 (big blind) folded before Flop
Seat 7: SweetCharity folded before Flop (didn't bet)
Seat 8: TheBigAceT folded before Flop (didn't bet)
Seat 9: moxiejan folded before Flop (didn't bet)

*********** # 82 **************
PokerStars Game #136598462: Tournament #376033, Hold'em Limit - Level VII (300/600) - 2003/10/05 - 01:40:24 (ET)
Table '376033 3' Seat #5 is the button
Seat 1: Starstealer (9530 in chips) 
Seat 2: MrsConcrete (6085 in chips) 
Seat 3: u_s_eh (2420 in chips) 
Seat 4: ralph roe (4560 in chips) 
Seat 5: bluesteele (15360 in chips) 
Seat 6: aeneas23 (3246 in chips) 
Seat 7: SweetCharity (5880 in chips) 
Seat 8: TheBigAceT (3625 in chips) 
Seat 9: moxiejan (630 in chips) 
aeneas23: posts small blind 150
SweetCharity: posts big blind 300
*** HOLE CARDS ***
Dealt to Starstealer [Th 9d]
TheBigAceT: folds 
moxiejan: folds 
Starstealer: folds 
MrsConcrete: folds 
u_s_eh is disconnected 
u_s_eh is connected 
u_s_eh: raises 300 to 600
ralph roe: folds 
bluesteele: folds 
aeneas23: calls 450
SweetCharity: folds 
*** FLOP *** [2s 9s 5s]
aeneas23: checks 
u_s_eh: bets 300
aeneas23: calls 300
*** TURN *** [2s 9s 5s] [4c]
aeneas23: checks 
u_s_eh: bets 600
aeneas23: calls 600
*** RIVER *** [2s 9s 5s 4c] [Ah]
aeneas23: bets 600
u_s_eh: raises 320 to 920 and is all-in
aeneas23: calls 320
*** SHOW DOWN ***
u_s_eh: shows [Ad Ac] (three of a kind, Aces)
aeneas23: shows [As Kh] (a pair of Aces)
u_s_eh collected 5140 from  pot
*** SUMMARY ***
Total pot 5140 | Rake 0 
Board [2s 9s 5s 4c Ah]
Seat 1: Starstealer folded before Flop (didn't bet)
Seat 2: MrsConcrete folded before Flop (didn't bet)
Seat 3: u_s_eh showed [Ad Ac] and won (5140) with three of a kind, Aces
Seat 4: ralph roe folded before Flop (didn't bet)
Seat 5: bluesteele (button) folded before Flop (didn't bet)
Seat 6: aeneas23 (small blind) showed [As Kh] and lost with a pair of Aces
Seat 7: SweetCharity (big blind) folded before Flop
Seat 8: TheBigAceT folded before Flop (didn't bet)
Seat 9: moxiejan folded before Flop (didn't bet)

*********** # 83 **************
PokerStars Game #136599610: Tournament #376033, Hold'em Limit - Level VII (300/600) - 2003/10/05 - 01:41:55 (ET)
Table '376033 3' Seat #6 is the button
Seat 1: Starstealer (9530 in chips) 
Seat 2: MrsConcrete (6085 in chips) 
Seat 3: u_s_eh (5140 in chips) 
Seat 4: ralph roe (4560 in chips) 
Seat 5: bluesteele (15360 in chips) 
Seat 6: aeneas23 (826 in chips) 
Seat 7: SweetCharity (5580 in chips) 
Seat 8: TheBigAceT (3625 in chips) 
Seat 9: moxiejan (630 in chips) 
SweetCharity: posts small blind 150
TheBigAceT: posts big blind 300
*** HOLE CARDS ***
Dealt to Starstealer [Qs 7s]
moxiejan: folds 
Starstealer: folds 
MrsConcrete: folds 
u_s_eh: folds 
ralph roe: folds 
bluesteele: calls 300
aeneas23: folds 
SweetCharity: calls 150
TheBigAceT: checks 
*** FLOP *** [8d Ac 6c]
SweetCharity: checks 
TheBigAceT: checks 
bluesteele: bets 300
SweetCharity: calls 300
TheBigAceT: folds 
*** TURN *** [8d Ac 6c] [7h]
SweetCharity: checks 
bluesteele: checks 
*** RIVER *** [8d Ac 6c 7h] [Jd]
SweetCharity: checks 
bluesteele: checks 
*** SHOW DOWN ***
SweetCharity: shows [Qc 9c] (high card Ace)
bluesteele: shows [Ks Kh] (a pair of Kings)
bluesteele collected 1500 from  pot
*** SUMMARY ***
Total pot 1500 | Rake 0 
Board [8d Ac 6c 7h Jd]
Seat 1: Starstealer folded before Flop (didn't bet)
Seat 2: MrsConcrete folded before Flop (didn't bet)
Seat 3: u_s_eh folded before Flop (didn't bet)
Seat 4: ralph roe folded before Flop (didn't bet)
Seat 5: bluesteele showed [Ks Kh] and won (1500) with a pair of Kings
Seat 6: aeneas23 (button) folded before Flop (didn't bet)
Seat 7: SweetCharity (small blind) showed [Qc 9c] and lost with high card Ace
Seat 8: TheBigAceT (big blind) folded on the Flop
Seat 9: moxiejan folded before Flop (didn't bet)

*********** # 84 **************
PokerStars Game #136601294: Tournament #376033, Hold'em Limit - Level VII (300/600) - 2003/10/05 - 01:44:08 (ET)
Table '376033 3' Seat #7 is the button
Seat 1: Starstealer (9530 in chips) 
Seat 2: MrsConcrete (6085 in chips) 
Seat 3: u_s_eh (5140 in chips) 
Seat 4: ralph roe (4560 in chips) 
Seat 5: bluesteele (16260 in chips) 
Seat 6: aeneas23 (826 in chips) 
Seat 7: SweetCharity (4980 in chips) 
Seat 8: TheBigAceT (3325 in chips) 
Seat 9: moxiejan (630 in chips) 
TheBigAceT: posts small blind 150
moxiejan: posts big blind 300
*** HOLE CARDS ***
Dealt to Starstealer [Ad Ac]
Starstealer: raises 300 to 600
MrsConcrete: folds 
u_s_eh: folds 
ralph roe: folds 
bluesteele: folds 
aeneas23: folds 
SweetCharity: folds 
TheBigAceT: folds 
moxiejan: calls 300
*** FLOP *** [3d Ts Td]
moxiejan: bets 30 and is all-in
Starstealer: calls 30
*** TURN *** [3d Ts Td] [5s]
*** RIVER *** [3d Ts Td 5s] [2h]
*** SHOW DOWN ***
moxiejan: shows [Jc Qh] (a pair of Tens)
Starstealer: shows [Ad Ac] (two pair, Aces and Tens)
Starstealer collected 1410 from  pot
*** SUMMARY ***
Total pot 1410 | Rake 0 
Board [3d Ts Td 5s 2h]
Seat 1: Starstealer showed [Ad Ac] and won (1410) with two pair, Aces and Tens
Seat 2: MrsConcrete folded before Flop (didn't bet)
Seat 3: u_s_eh folded before Flop (didn't bet)
Seat 4: ralph roe folded before Flop (didn't bet)
Seat 5: bluesteele folded before Flop (didn't bet)
Seat 6: aeneas23 folded before Flop (didn't bet)
Seat 7: SweetCharity (button) folded before Flop (didn't bet)
Seat 8: TheBigAceT (small blind) folded before Flop
Seat 9: moxiejan (big blind) showed [Jc Qh] and lost with a pair of Tens

*********** # 85 **************
PokerStars Game #136601938: Tournament #376033, Hold'em Limit - Level VII (300/600) - 2003/10/05 - 01:44:57 (ET)
Table '376033 11' Seat #8 is the button
Seat 1: kenocathy (3145 in chips) 
Seat 2: Morcold (8880 in chips) 
Seat 3: skm_garland (1415 in chips) 
Seat 4: FLHRIDER (6570 in chips) 
Seat 5: Starstealer (10310 in chips) 
Seat 6: benj@mins$ (2100 in chips) 
Seat 7: maq2000 (4485 in chips) 
Seat 8: turtle (4015 in chips) 
Seat 9: 1BigDave (7730 in chips) 
1BigDave: posts small blind 150
kenocathy: posts big blind 300
*** HOLE CARDS ***
Dealt to Starstealer [9h 5d]
Morcold: folds 
skm_garland: calls 300
FLHRIDER: calls 300
Starstealer: folds 
benj@mins$: folds 
maq2000: folds 
turtle: folds 
1BigDave: calls 150
kenocathy: checks 
*** FLOP *** [5h Td 3d]
1BigDave: checks 
kenocathy: checks 
skm_garland: checks 
FLHRIDER: checks 
*** TURN *** [5h Td 3d] [Kh]
1BigDave: checks 
kenocathy: checks 
skm_garland: checks 
FLHRIDER: checks 
*** RIVER *** [5h Td 3d Kh] [8h]
1BigDave: checks 
kenocathy: checks 
skm_garland: checks 
FLHRIDER: checks 
*** SHOW DOWN ***
1BigDave: shows [Ad Qc] (high card Ace)
kenocathy: mucks hand 
skm_garland: mucks hand 
FLHRIDER: shows [Qs Ts] (a pair of Tens)
FLHRIDER collected 1200 from  pot
*** SUMMARY ***
Total pot 1200 | Rake 0 
Board [5h Td 3d Kh 8h]
Seat 1: kenocathy (big blind) mucked [Qd 6h] - high card King
Seat 2: Morcold folded before Flop (didn't bet)
Seat 3: skm_garland mucked [Ah 4c] - high card Ace
Seat 4: FLHRIDER showed [Qs Ts] and won (1200) with a pair of Tens
Seat 5: Starstealer folded before Flop (didn't bet)
Seat 6: benj@mins$ folded before Flop (didn't bet)
Seat 7: maq2000 folded before Flop (didn't bet)
Seat 8: turtle (button) folded before Flop (didn't bet)
Seat 9: 1BigDave (small blind) showed [Ad Qc] and lost with high card Ace

*********** # 86 **************
PokerStars Game #136602945: Tournament #376033, Hold'em Limit - Level VII (300/600) - 2003/10/05 - 01:46:19 (ET)
Table '376033 11' Seat #9 is the button
Seat 1: kenocathy (2845 in chips) 
Seat 2: Morcold (8880 in chips) 
Seat 3: skm_garland (1115 in chips) 
Seat 4: FLHRIDER (7470 in chips) 
Seat 5: Starstealer (10310 in chips) 
Seat 6: benj@mins$ (2100 in chips) 
Seat 7: maq2000 (4485 in chips) 
Seat 8: turtle (4015 in chips) 
Seat 9: 1BigDave (7430 in chips) 
kenocathy: posts small blind 150
Morcold: posts big blind 300
*** HOLE CARDS ***
Dealt to Starstealer [Ts 5d]
skm_garland: folds 
FLHRIDER: calls 300
Starstealer: folds 
benj@mins$: folds 
maq2000: folds 
turtle: raises 300 to 600
1BigDave: folds 
kenocathy: folds 
Morcold: calls 300
FLHRIDER: calls 300
*** FLOP *** [Qs Js 7d]
Morcold: bets 300
FLHRIDER: calls 300
turtle: calls 300
*** TURN *** [Qs Js 7d] [2d]
Morcold: bets 600
FLHRIDER: calls 600
turtle: calls 600
*** RIVER *** [Qs Js 7d 2d] [3c]
Morcold: checks 
FLHRIDER: checks 
turtle: bets 600
Morcold: folds 
FLHRIDER: calls 600
*** SHOW DOWN ***
turtle: shows [Ad Ah] (a pair of Aces)
FLHRIDER: mucks hand 
turtle collected 5850 from  pot
*** SUMMARY ***
Total pot 5850 | Rake 0 
Board [Qs Js 7d 2d 3c]
Seat 1: kenocathy (small blind) folded before Flop
Seat 2: Morcold (big blind) folded on the River
Seat 3: skm_garland folded before Flop (didn't bet)
Seat 4: FLHRIDER mucked [Qd 8h] - a pair of Queens
Seat 5: Starstealer folded before Flop (didn't bet)
Seat 6: benj@mins$ folded before Flop (didn't bet)
Seat 7: maq2000 folded before Flop (didn't bet)
Seat 8: turtle showed [Ad Ah] and won (5850) with a pair of Aces
Seat 9: 1BigDave (button) folded before Flop (didn't bet)

*********** # 87 **************
PokerStars Game #136603933: Tournament #376033, Hold'em Limit - Level VII (300/600) - 2003/10/05 - 01:47:36 (ET)
Table '376033 11' Seat #1 is the button
Seat 1: kenocathy (2695 in chips) 
Seat 2: Morcold (7380 in chips) 
Seat 3: skm_garland (1115 in chips) 
Seat 4: FLHRIDER (5370 in chips) 
Seat 5: Starstealer (10310 in chips) 
Seat 6: benj@mins$ (2100 in chips) 
Seat 7: maq2000 (4485 in chips) 
Seat 8: turtle (7765 in chips) 
Seat 9: 1BigDave (7430 in chips) 
Morcold: posts small blind 150
skm_garland: posts big blind 300
*** HOLE CARDS ***
Dealt to Starstealer [Kh Tc]
FLHRIDER: calls 300
Starstealer: folds 
benj@mins$: folds 
maq2000: folds 
turtle: folds 
1BigDave: folds 
kenocathy: calls 300
Morcold: folds 
skm_garland: raises 300 to 600
FLHRIDER: calls 300
kenocathy: calls 300
*** FLOP *** [Ad 5s Td]
skm_garland: checks 
FLHRIDER: checks 
kenocathy: checks 
*** TURN *** [Ad 5s Td] [6c]
skm_garland: bets 515 and is all-in
FLHRIDER: calls 515
kenocathy: calls 515
*** RIVER *** [Ad 5s Td 6c] [9c]
FLHRIDER: checks 
kenocathy: checks 
*** SHOW DOWN ***
skm_garland: shows [Ac Ks] (a pair of Aces)
FLHRIDER: mucks hand 
kenocathy: shows [As 5d] (two pair, Aces and Fives)
kenocathy collected 3495 from  pot
*** SUMMARY ***
Total pot 3495 | Rake 0 
Board [Ad 5s Td 6c 9c]
Seat 1: kenocathy (button) showed [As 5d] and won (3495) with two pair, Aces and Fives
Seat 2: Morcold (small blind) folded before Flop
Seat 3: skm_garland (big blind) showed [Ac Ks] and lost with a pair of Aces
Seat 4: FLHRIDER mucked [9s Jd] - a pair of Nines
Seat 5: Starstealer folded before Flop (didn't bet)
Seat 6: benj@mins$ folded before Flop (didn't bet)
Seat 7: maq2000 folded before Flop (didn't bet)
Seat 8: turtle folded before Flop (didn't bet)
Seat 9: 1BigDave folded before Flop (didn't bet)

*********** # 88 **************
PokerStars Game #136604855: Tournament #376033, Hold'em Limit - Level VII (300/600) - 2003/10/05 - 01:48:48 (ET)
Table '376033 11' Seat #2 is the button
Seat 1: kenocathy (5075 in chips) 
Seat 2: Morcold (7230 in chips) 
Seat 4: FLHRIDER (4255 in chips) 
Seat 5: Starstealer (10310 in chips) 
Seat 6: benj@mins$ (2100 in chips) 
Seat 7: maq2000 (4485 in chips) 
Seat 8: turtle (7765 in chips) 
Seat 9: 1BigDave (7430 in chips) 
FLHRIDER: posts small blind 150
Starstealer: posts big blind 300
*** HOLE CARDS ***
Dealt to Starstealer [Qs 2h]
benj@mins$: folds 
maq2000: calls 300
turtle: folds 
1BigDave: folds 
kenocathy: folds 
Morcold: folds 
FLHRIDER: calls 150
Starstealer: checks 
*** FLOP *** [3c 5h Tc]
FLHRIDER: checks 
Starstealer: checks 
maq2000: bets 300
FLHRIDER: folds 
Starstealer: folds 
skm_garland [observer] said, "AK the best hand i got all tourney and cant win cant believe i made it this far"
maq2000 collected 900 from  pot
maq2000: doesn't show hand 
*** SUMMARY ***
Total pot 900 | Rake 0 
Board [3c 5h Tc]
Seat 1: kenocathy folded before Flop (didn't bet)
Seat 2: Morcold (button) folded before Flop (didn't bet)
Seat 4: FLHRIDER (small blind) folded on the Flop
Seat 5: Starstealer (big blind) folded on the Flop
Seat 6: benj@mins$ folded before Flop (didn't bet)
Seat 7: maq2000 collected (900)
Seat 8: turtle folded before Flop (didn't bet)
Seat 9: 1BigDave folded before Flop (didn't bet)

*********** # 89 **************
PokerStars Game #136605429: Tournament #376033, Hold'em Limit - Level VII (300/600) - 2003/10/05 - 01:49:31 (ET)
Table '376033 11' Seat #4 is the button
Seat 1: kenocathy (5075 in chips) 
Seat 2: Morcold (7230 in chips) 
Seat 4: FLHRIDER (3955 in chips) 
Seat 5: Starstealer (10010 in chips) 
Seat 6: benj@mins$ (2100 in chips) 
Seat 7: maq2000 (5085 in chips) 
Seat 8: turtle (7765 in chips) 
Seat 9: 1BigDave (7430 in chips) 
Starstealer: posts small blind 150
benj@mins$: posts big blind 300
*** HOLE CARDS ***
Dealt to Starstealer [Th 4h]
maq2000: folds 
turtle: folds 
1BigDave: folds 
kenocathy: folds 
Morcold: folds 
FLHRIDER: folds 
Starstealer: folds 
benj@mins$ collected 300 from  pot
benj@mins$: doesn't show hand 
*** SUMMARY ***
Total pot 300 | Rake 0 
Seat 1: kenocathy folded before Flop (didn't bet)
Seat 2: Morcold folded before Flop (didn't bet)
Seat 4: FLHRIDER (button) folded before Flop (didn't bet)
Seat 5: Starstealer (small blind) folded before Flop
Seat 6: benj@mins$ (big blind) collected (300)
Seat 7: maq2000 folded before Flop (didn't bet)
Seat 8: turtle folded before Flop (didn't bet)
Seat 9: 1BigDave folded before Flop (didn't bet)

*********** # 90 **************
PokerStars Game #136605655: Tournament #376033, Hold'em Limit - Level VII (300/600) - 2003/10/05 - 01:49:50 (ET)
Table '376033 11' Seat #5 is the button
Seat 1: kenocathy (5075 in chips) 
Seat 2: Morcold (7230 in chips) 
Seat 4: FLHRIDER (3955 in chips) 
Seat 5: Starstealer (9860 in chips) 
Seat 6: benj@mins$ (2250 in chips) 
Seat 7: maq2000 (5085 in chips) 
Seat 8: turtle (7765 in chips) 
Seat 9: 1BigDave (7430 in chips) 
benj@mins$: posts small blind 150
maq2000: posts big blind 300
*** HOLE CARDS ***
Dealt to Starstealer [8s 9d]
turtle: folds 
1BigDave: folds 
kenocathy: folds 
Morcold: calls 300
FLHRIDER: folds 
Starstealer: folds 
benj@mins$: raises 300 to 600
maq2000: folds 
Morcold: calls 300
*** FLOP *** [Kc Jc Qs]
benj@mins$: bets 300
Morcold: raises 300 to 600
benj@mins$: calls 300
*** TURN *** [Kc Jc Qs] [Jd]
benj@mins$: checks 
Morcold: bets 600
benj@mins$: calls 600
*** RIVER *** [Kc Jc Qs Jd] [6d]
benj@mins$: checks 
Morcold: bets 600
benj@mins$: calls 450 and is all-in
*** SHOW DOWN ***
Morcold: shows [Td As] (a straight, Ten to Ace)
benj@mins$: shows [Th Tc] (two pair, Jacks and Tens)
Morcold collected 4800 from  pot
*** SUMMARY ***
Total pot 4800 | Rake 0 
Board [Kc Jc Qs Jd 6d]
Seat 1: kenocathy folded before Flop (didn't bet)
Seat 2: Morcold showed [Td As] and won (4800) with a straight, Ten to Ace
Seat 4: FLHRIDER folded before Flop (didn't bet)
Seat 5: Starstealer (button) folded before Flop (didn't bet)
Seat 6: benj@mins$ (small blind) showed [Th Tc] and lost with two pair, Jacks and Tens
Seat 7: maq2000 (big blind) folded before Flop
Seat 8: turtle folded before Flop (didn't bet)
Seat 9: 1BigDave folded before Flop (didn't bet)

*********** # 91 **************
PokerStars Game #136606438: Tournament #376033, Hold'em Limit - Level VIII (400/800) - 2003/10/05 - 01:50:48 (ET)
Table '376033 11' Seat #7 is the button
Seat 1: kenocathy (5075 in chips) 
Seat 2: Morcold (9780 in chips) 
Seat 4: FLHRIDER (3955 in chips) 
Seat 5: Starstealer (9860 in chips) 
Seat 7: maq2000 (4785 in chips) 
Seat 8: turtle (7765 in chips) 
Seat 9: 1BigDave (7430 in chips) 
turtle: posts small blind 200
1BigDave: posts big blind 400
*** HOLE CARDS ***
Dealt to Starstealer [9c Tc]
Big Jag is connected 
kenocathy: folds 
Morcold: folds 
FLHRIDER: folds 
Starstealer: folds 
maq2000: folds 
turtle: folds 
1BigDave collected 400 from  pot
1BigDave: doesn't show hand 
*** SUMMARY ***
Total pot 400 | Rake 0 
Seat 1: kenocathy folded before Flop (didn't bet)
Seat 2: Morcold folded before Flop (didn't bet)
Seat 4: FLHRIDER folded before Flop (didn't bet)
Seat 5: Starstealer folded before Flop (didn't bet)
Seat 7: maq2000 (button) folded before Flop (didn't bet)
Seat 8: turtle (small blind) folded before Flop
Seat 9: 1BigDave (big blind) collected (400)

*********** # 92 **************
PokerStars Game #136606838: Tournament #376033, Hold'em Limit - Level VIII (400/800) - 2003/10/05 - 01:51:19 (ET)
Table '376033 11' Seat #8 is the button
Seat 1: kenocathy (5075 in chips) 
Seat 2: Morcold (9780 in chips) 
Seat 3: Big Jag (5959 in chips) 
Seat 4: FLHRIDER (3955 in chips) 
Seat 5: Starstealer (9860 in chips) 
Seat 7: maq2000 (4785 in chips) 
Seat 8: turtle (7565 in chips) 
Seat 9: 1BigDave (7630 in chips) 
1BigDave: posts small blind 200
kenocathy: posts big blind 400
*** HOLE CARDS ***
Dealt to Starstealer [Jd 2s]
Morcold: calls 400
Big Jag: raises 400 to 800
L Loco is connected 
FLHRIDER: folds 
Starstealer: folds 
maq2000: folds 
turtle: folds 
1BigDave: folds 
kenocathy: calls 400
Morcold: calls 400
*** FLOP *** [2c 7s Ks]
kenocathy: checks 
Morcold: checks 
Big Jag: bets 400
kenocathy: calls 400
Morcold: folds 
*** TURN *** [2c 7s Ks] [7d]
kenocathy: checks 
Big Jag: bets 800
kenocathy: calls 800
*** RIVER *** [2c 7s Ks 7d] [3c]
kenocathy: checks 
Big Jag: bets 800
kenocathy: calls 800
*** SHOW DOWN ***
Big Jag: shows [Qh Qd] (two pair, Queens and Sevens)
kenocathy: shows [As Kc] (two pair, Kings and Sevens)
kenocathy collected 6600 from  pot
*** SUMMARY ***
Total pot 6600 | Rake 0 
Board [2c 7s Ks 7d 3c]
Seat 1: kenocathy (big blind) showed [As Kc] and won (6600) with two pair, Kings and Sevens
Seat 2: Morcold folded on the Flop
Seat 3: Big Jag showed [Qh Qd] and lost with two pair, Queens and Sevens
Seat 4: FLHRIDER folded before Flop (didn't bet)
Seat 5: Starstealer folded before Flop (didn't bet)
Seat 7: maq2000 folded before Flop (didn't bet)
Seat 8: turtle (button) folded before Flop (didn't bet)
Seat 9: 1BigDave (small blind) folded before Flop

*********** # 93 **************
PokerStars Game #136607985: Tournament #376033, Hold'em Limit - Level VIII (400/800) - 2003/10/05 - 01:52:48 (ET)
Table '376033 11' Seat #9 is the button
Seat 1: kenocathy (8875 in chips) 
Seat 2: Morcold (8980 in chips) 
Seat 3: Big Jag (3159 in chips) 
Seat 4: FLHRIDER (3955 in chips) 
Seat 5: Starstealer (9860 in chips) 
Seat 6: L Loco (7670 in chips) 
Seat 7: maq2000 (4785 in chips) 
Seat 8: turtle (7565 in chips) 
Seat 9: 1BigDave (7430 in chips) 
kenocathy: posts small blind 200
Morcold: posts big blind 400
*** HOLE CARDS ***
Dealt to Starstealer [Js 2s]
Big Jag: folds 
FLHRIDER: calls 400
Starstealer: folds 
L Loco: folds 
maq2000: folds 
turtle: folds 
1BigDave: folds 
kenocathy: calls 200
Morcold: checks 
*** FLOP *** [As 3d 2h]
kenocathy: checks 
Morcold: checks 
FLHRIDER: bets 400
kenocathy: calls 400
Morcold: folds 
*** TURN *** [As 3d 2h] [8d]
kenocathy: checks 
FLHRIDER: bets 800
kenocathy: calls 800
*** RIVER *** [As 3d 2h 8d] [4h]
kenocathy: checks 
FLHRIDER: bets 800
kenocathy: calls 800
*** SHOW DOWN ***
FLHRIDER: shows [5c Ad] (a straight, Ace to Five)
kenocathy: mucks hand 
FLHRIDER collected 5200 from  pot
*** SUMMARY ***
Total pot 5200 | Rake 0 
Board [As 3d 2h 8d 4h]
Seat 1: kenocathy (small blind) mucked [Ah 9h] - a pair of Aces
Seat 2: Morcold (big blind) folded on the Flop
Seat 3: Big Jag folded before Flop (didn't bet)
Seat 4: FLHRIDER showed [5c Ad] and won (5200) with a straight, Ace to Five
Seat 5: Starstealer folded before Flop (didn't bet)
Seat 6: L Loco folded before Flop (didn't bet)
Seat 7: maq2000 folded before Flop (didn't bet)
Seat 8: turtle folded before Flop (didn't bet)
Seat 9: 1BigDave (button) folded before Flop (didn't bet)

*********** # 94 **************
PokerStars Game #136609095: Tournament #376033, Hold'em Limit - Level VIII (400/800) - 2003/10/05 - 01:54:15 (ET)
Table '376033 11' Seat #1 is the button
Seat 1: kenocathy (6475 in chips) 
Seat 2: Morcold (8580 in chips) 
Seat 3: Big Jag (3159 in chips) 
Seat 4: FLHRIDER (6755 in chips) 
Seat 5: Starstealer (9860 in chips) 
Seat 6: L Loco (7670 in chips) 
Seat 7: maq2000 (4785 in chips) 
Seat 8: turtle (7565 in chips) 
Seat 9: 1BigDave (7430 in chips) 
Morcold: posts small blind 200
Big Jag: posts big blind 400
*** HOLE CARDS ***
Dealt to Starstealer [As Tc]
FLHRIDER: calls 400
Starstealer: folds 
L Loco: folds 
maq2000: folds 
turtle: folds 
1BigDave: folds 
kenocathy: folds 
Morcold: folds 
Big Jag: checks 
*** FLOP *** [3d 8s Ad]
Big Jag: checks 
FLHRIDER: checks 
*** TURN *** [3d 8s Ad] [9h]
Big Jag: bets 800
FLHRIDER: calls 800
*** RIVER *** [3d 8s Ad 9h] [Qd]
Big Jag: bets 800
FLHRIDER: folds 
Big Jag collected 2600 from  pot
Big Jag: doesn't show hand 
*** SUMMARY ***
Total pot 2600 | Rake 0 
Board [3d 8s Ad 9h Qd]
Seat 1: kenocathy (button) folded before Flop (didn't bet)
Seat 2: Morcold (small blind) folded before Flop
Seat 3: Big Jag (big blind) collected (2600)
Seat 4: FLHRIDER folded on the River
Seat 5: Starstealer folded before Flop (didn't bet)
Seat 6: L Loco folded before Flop (didn't bet)
Seat 7: maq2000 folded before Flop (didn't bet)
Seat 8: turtle folded before Flop (didn't bet)
Seat 9: 1BigDave folded before Flop (didn't bet)

*********** # 95 **************
PokerStars Game #136610002: Tournament #376033, Hold'em Limit - Level VIII (400/800) - 2003/10/05 - 01:55:27 (ET)
Table '376033 11' Seat #2 is the button
Seat 1: kenocathy (6475 in chips) 
Seat 2: Morcold (8380 in chips) 
Seat 3: Big Jag (4559 in chips) 
Seat 4: FLHRIDER (5555 in chips) 
Seat 5: Starstealer (9860 in chips) 
Seat 6: L Loco (7670 in chips) 
Seat 7: maq2000 (4785 in chips) 
Seat 8: turtle (7565 in chips) 
Seat 9: 1BigDave (7430 in chips) 
Big Jag: posts small blind 200
FLHRIDER: posts big blind 400
*** HOLE CARDS ***
Dealt to Starstealer [9h Tc]
Starstealer: folds 
L Loco: calls 400
maq2000: folds 
turtle: folds 
1BigDave: folds 
kenocathy: folds 
Morcold: folds 
Big Jag: calls 200
FLHRIDER: checks 
*** FLOP *** [Td Qd 6h]
Big Jag: checks 
FLHRIDER: checks 
L Loco: checks 
*** TURN *** [Td Qd 6h] [Kh]
Big Jag: checks 
FLHRIDER: bets 800
L Loco: folds 
Big Jag: folds 
FLHRIDER collected 1200 from  pot
FLHRIDER: doesn't show hand 
*** SUMMARY ***
Total pot 1200 | Rake 0 
Board [Td Qd 6h Kh]
Seat 1: kenocathy folded before Flop (didn't bet)
Seat 2: Morcold (button) folded before Flop (didn't bet)
Seat 3: Big Jag (small blind) folded on the Turn
Seat 4: FLHRIDER (big blind) collected (1200)
Seat 5: Starstealer folded before Flop (didn't bet)
Seat 6: L Loco folded on the Turn
Seat 7: maq2000 folded before Flop (didn't bet)
Seat 8: turtle folded before Flop (didn't bet)
Seat 9: 1BigDave folded before Flop (didn't bet)

*********** # 96 **************
PokerStars Game #136610591: Tournament #376033, Hold'em Limit - Level VIII (400/800) - 2003/10/05 - 01:56:13 (ET)
Table '376033 11' Seat #3 is the button
Seat 1: kenocathy (6475 in chips) 
Seat 2: Morcold (8380 in chips) 
Seat 3: Big Jag (4159 in chips) 
Seat 4: FLHRIDER (6355 in chips) 
Seat 5: Starstealer (9860 in chips) 
Seat 6: L Loco (7270 in chips) 
Seat 7: maq2000 (4785 in chips) 
Seat 8: turtle (7565 in chips) 
Seat 9: 1BigDave (7430 in chips) 
FLHRIDER: posts small blind 200
Starstealer: posts big blind 400
*** HOLE CARDS ***
Dealt to Starstealer [Jh 6h]
L Loco: folds 
maq2000: folds 
turtle: folds 
1BigDave: folds 
kenocathy: folds 
Morcold: raises 400 to 800
Big Jag: calls 800
FLHRIDER: calls 600
Starstealer: folds 
*** FLOP *** [4c Ts 9h]
FLHRIDER: checks 
Morcold: checks 
Big Jag: checks 
*** TURN *** [4c Ts 9h] [6s]
FLHRIDER: checks 
Morcold: bets 800
Big Jag: calls 800
FLHRIDER: folds 
*** RIVER *** [4c Ts 9h 6s] [2s]
Morcold: checks 
Big Jag: checks 
*** SHOW DOWN ***
Morcold: shows [8d Ad] (high card Ace)
Big Jag: shows [7d 7h] (a pair of Sevens)
Big Jag collected 4400 from  pot
*** SUMMARY ***
Total pot 4400 | Rake 0 
Board [4c Ts 9h 6s 2s]
Seat 1: kenocathy folded before Flop (didn't bet)
Seat 2: Morcold showed [8d Ad] and lost with high card Ace
Seat 3: Big Jag (button) showed [7d 7h] and won (4400) with a pair of Sevens
Seat 4: FLHRIDER (small blind) folded on the Turn
Seat 5: Starstealer (big blind) folded before Flop
Seat 6: L Loco folded before Flop (didn't bet)
Seat 7: maq2000 folded before Flop (didn't bet)
Seat 8: turtle folded before Flop (didn't bet)
Seat 9: 1BigDave folded before Flop (didn't bet)

*********** # 97 **************
PokerStars Game #136611419: Tournament #376033, Hold'em Limit - Level VIII (400/800) - 2003/10/05 - 01:57:19 (ET)
Table '376033 11' Seat #4 is the button
Seat 1: kenocathy (6475 in chips) 
Seat 2: Morcold (6780 in chips) 
Seat 3: Big Jag (6959 in chips) 
Seat 4: FLHRIDER (5555 in chips) 
Seat 5: Starstealer (9460 in chips) 
Seat 6: L Loco (7270 in chips) 
Seat 7: maq2000 (4785 in chips) 
Seat 8: turtle (7565 in chips) 
Seat 9: 1BigDave (7430 in chips) 
Starstealer: posts small blind 200
L Loco: posts big blind 400
*** HOLE CARDS ***
Dealt to Starstealer [Ts 3h]
maq2000: folds 
turtle: folds 
1BigDave: folds 
kenocathy: folds 
Morcold: calls 400
Big Jag: folds 
FLHRIDER: calls 400
Starstealer: folds 
L Loco: checks 
*** FLOP *** [Qd Tc 3c]
L Loco: checks 
Morcold: checks 
FLHRIDER: checks 
*** TURN *** [Qd Tc 3c] [9c]
L Loco: checks 
Morcold: checks 
FLHRIDER: checks 
*** RIVER *** [Qd Tc 3c 9c] [7d]
L Loco: checks 
Morcold: checks 
FLHRIDER: checks 
*** SHOW DOWN ***
L Loco: shows [4d 5h] (high card Queen)
Morcold: shows [4h Kh] (high card King)
FLHRIDER: shows [Ad 6s] (high card Ace)
FLHRIDER collected 1400 from  pot
*** SUMMARY ***
Total pot 1400 | Rake 0 
Board [Qd Tc 3c 9c 7d]
Seat 1: kenocathy folded before Flop (didn't bet)
Seat 2: Morcold showed [4h Kh] and lost with high card King
Seat 3: Big Jag folded before Flop (didn't bet)
Seat 4: FLHRIDER (button) showed [Ad 6s] and won (1400) with high card Ace
Seat 5: Starstealer (small blind) folded before Flop
Seat 6: L Loco (big blind) showed [4d 5h] and lost with high card Queen
Seat 7: maq2000 folded before Flop (didn't bet)
Seat 8: turtle folded before Flop (didn't bet)
Seat 9: 1BigDave folded before Flop (didn't bet)

*********** # 98 **************
PokerStars Game #136612083: Tournament #376033, Hold'em Limit - Level VIII (400/800) - 2003/10/05 - 01:58:14 (ET)
Table '376033 11' Seat #5 is the button
Seat 1: kenocathy (6475 in chips) 
Seat 2: Morcold (6380 in chips) 
Seat 3: Big Jag (6959 in chips) 
Seat 4: FLHRIDER (6555 in chips) 
Seat 5: Starstealer (9260 in chips) 
Seat 6: L Loco (6870 in chips) 
Seat 7: maq2000 (4785 in chips) 
Seat 8: turtle (7565 in chips) 
Seat 9: 1BigDave (7430 in chips) 
L Loco: posts small blind 200
maq2000: posts big blind 400
*** HOLE CARDS ***
Dealt to Starstealer [2d 6h]
turtle: folds 
1BigDave: folds 
kenocathy: calls 400
Morcold: folds 
Big Jag: folds 
FLHRIDER: calls 400
Starstealer: folds 
L Loco: folds 
maq2000: checks 
*** FLOP *** [Td 9d 3s]
maq2000: bets 400
kenocathy: folds 
FLHRIDER: calls 400
*** TURN *** [Td 9d 3s] [Jc]
maq2000: bets 800
FLHRIDER: calls 800
*** RIVER *** [Td 9d 3s Jc] [Jh]
maq2000: bets 800
FLHRIDER: calls 800
*** SHOW DOWN ***
maq2000: shows [9c 3d] (two pair, Jacks and Nines)
FLHRIDER: shows [Js 7d] (three of a kind, Jacks)
FLHRIDER collected 5400 from  pot
*** SUMMARY ***
Total pot 5400 | Rake 0 
Board [Td 9d 3s Jc Jh]
Seat 1: kenocathy folded on the Flop
Seat 2: Morcold folded before Flop (didn't bet)
Seat 3: Big Jag folded before Flop (didn't bet)
Seat 4: FLHRIDER showed [Js 7d] and won (5400) with three of a kind, Jacks
Seat 5: Starstealer (button) folded before Flop (didn't bet)
Seat 6: L Loco (small blind) folded before Flop
Seat 7: maq2000 (big blind) showed [9c 3d] and lost with two pair, Jacks and Nines
Seat 8: turtle folded before Flop (didn't bet)
Seat 9: 1BigDave folded before Flop (didn't bet)

*********** # 99 **************
PokerStars Game #136612774: Tournament #376033, Hold'em Limit - Level VIII (400/800) - 2003/10/05 - 01:59:09 (ET)
Table '376033 11' Seat #6 is the button
Seat 1: kenocathy (6075 in chips) 
Seat 2: Morcold (6380 in chips) 
Seat 3: Big Jag (6959 in chips) 
Seat 4: FLHRIDER (9555 in chips) 
Seat 5: Starstealer (9260 in chips) 
Seat 6: L Loco (6670 in chips) 
Seat 7: maq2000 (2385 in chips) 
Seat 8: turtle (7565 in chips) 
Seat 9: 1BigDave (7430 in chips) 
maq2000: posts small blind 200
turtle: posts big blind 400
*** HOLE CARDS ***
Dealt to Starstealer [5d Qh]
1BigDave: folds 
kenocathy: calls 400
Morcold: folds 
Big Jag: folds 
FLHRIDER: folds 
Starstealer: folds 
L Loco: folds 
maq2000: calls 200
turtle: checks 
*** FLOP *** [Js 7d 9d]
maq2000: checks 
turtle: bets 400
kenocathy: folds 
maq2000: calls 400
*** TURN *** [Js 7d 9d] [8s]
maq2000: checks 
turtle: bets 800
maq2000: raises 785 to 1585 and is all-in
turtle: calls 785
*** RIVER *** [Js 7d 9d 8s] [Qs]
*** SHOW DOWN ***
maq2000: shows [Kc Td] (a straight, Nine to King)
turtle: shows [8c Tc] (a straight, Eight to Queen)
maq2000 collected 5170 from  pot
*** SUMMARY ***
Total pot 5170 | Rake 0 
Board [Js 7d 9d 8s Qs]
Seat 1: kenocathy folded on the Flop
Seat 2: Morcold folded before Flop (didn't bet)
Seat 3: Big Jag folded before Flop (didn't bet)
Seat 4: FLHRIDER folded before Flop (didn't bet)
Seat 5: Starstealer folded before Flop (didn't bet)
Seat 6: L Loco (button) folded before Flop (didn't bet)
Seat 7: maq2000 (small blind) showed [Kc Td] and won (5170) with a straight, Nine to King
Seat 8: turtle (big blind) showed [8c Tc] and lost with a straight, Eight to Queen
Seat 9: 1BigDave folded before Flop (didn't bet)

*********** # 100 **************
PokerStars Game #136613982: Tournament #376033, Hold'em Limit - Level VIII (400/800) - 2003/10/05 - 02:00:46 (ET)
Table '376033 11' Seat #7 is the button
Seat 1: kenocathy (5675 in chips) 
Seat 2: Morcold (6380 in chips) 
Seat 3: Big Jag (6959 in chips) 
Seat 4: FLHRIDER (9555 in chips) 
Seat 5: Starstealer (9260 in chips) 
Seat 6: L Loco (6670 in chips) 
Seat 7: maq2000 (5170 in chips) 
Seat 8: turtle (5180 in chips) 
Seat 9: 1BigDave (7430 in chips) 
turtle: posts small blind 200
1BigDave: posts big blind 400
*** HOLE CARDS ***
Dealt to Starstealer [Jc 7d]
kenocathy: folds 
Morcold: folds 
Big Jag: folds 
FLHRIDER: folds 
Starstealer: folds 
L Loco: folds 
maq2000: raises 400 to 800
turtle: calls 600
1BigDave: folds 
*** FLOP *** [2c As 2h]
turtle: checks 
maq2000: bets 400
turtle: folds 
maq2000 collected 2000 from  pot
maq2000: doesn't show hand 
*** SUMMARY ***
Total pot 2000 | Rake 0 
Board [2c As 2h]
Seat 1: kenocathy folded before Flop (didn't bet)
Seat 2: Morcold folded before Flop (didn't bet)
Seat 3: Big Jag folded before Flop (didn't bet)
Seat 4: FLHRIDER folded before Flop (didn't bet)
Seat 5: Starstealer folded before Flop (didn't bet)
Seat 6: L Loco folded before Flop (didn't bet)
Seat 7: maq2000 (button) collected (2000)
Seat 8: turtle (small blind) folded on the Flop
Seat 9: 1BigDave (big blind) folded before Flop

*********** # 101 **************
PokerStars Game #136614496: Tournament #376033, Hold'em Limit - Level VIII (400/800) - 2003/10/05 - 02:01:30 (ET)
Table '376033 11' Seat #8 is the button
Seat 1: kenocathy (5675 in chips) 
Seat 2: Morcold (6380 in chips) 
Seat 3: Big Jag (6959 in chips) 
Seat 4: FLHRIDER (9555 in chips) 
Seat 5: Starstealer (9260 in chips) 
Seat 6: L Loco (6670 in chips) 
Seat 7: maq2000 (6370 in chips) 
Seat 8: turtle (4380 in chips) 
Seat 9: 1BigDave (7030 in chips) 
1BigDave: posts small blind 200
kenocathy: posts big blind 400
*** HOLE CARDS ***
Dealt to Starstealer [6h 5h]
Morcold: folds 
Big Jag: folds 
FLHRIDER: calls 400
Starstealer: folds 
L Loco: folds 
maq2000: calls 400
turtle: folds 
1BigDave: folds 
kenocathy: checks 
*** FLOP *** [6c Jd 7s]
kenocathy: checks 
FLHRIDER: checks 
maq2000: bets 400
kenocathy: folds 
FLHRIDER: folds 
maq2000 collected 1400 from  pot
maq2000: doesn't show hand 
*** SUMMARY ***
Total pot 1400 | Rake 0 
Board [6c Jd 7s]
Seat 1: kenocathy (big blind) folded on the Flop
Seat 2: Morcold folded before Flop (didn't bet)
Seat 3: Big Jag folded before Flop (didn't bet)
Seat 4: FLHRIDER folded on the Flop
Seat 5: Starstealer folded before Flop (didn't bet)
Seat 6: L Loco folded before Flop (didn't bet)
Seat 7: maq2000 collected (1400)
Seat 8: turtle (button) folded before Flop (didn't bet)
Seat 9: 1BigDave (small blind) folded before Flop

*********** # 102 **************
PokerStars Game #136615037: Tournament #376033, Hold'em Limit - Level VIII (400/800) - 2003/10/05 - 02:02:15 (ET)
Table '376033 11' Seat #9 is the button
Seat 1: kenocathy (5275 in chips) 
Seat 2: Morcold (6380 in chips) 
Seat 3: Big Jag (6959 in chips) 
Seat 4: FLHRIDER (9155 in chips) 
Seat 5: Starstealer (9260 in chips) 
Seat 6: L Loco (6670 in chips) 
Seat 7: maq2000 (7370 in chips) 
Seat 8: turtle (4380 in chips) 
Seat 9: 1BigDave (6830 in chips) 
kenocathy: posts small blind 200
Morcold: posts big blind 400
*** HOLE CARDS ***
Dealt to Starstealer [5d Kc]
Big Jag: folds 
FLHRIDER: folds 
Starstealer: folds 
L Loco: calls 400
maq2000: folds 
turtle: folds 
1BigDave: folds 
kenocathy: calls 200
Morcold: checks 
*** FLOP *** [8h 9s 8d]
kenocathy: checks 
Morcold: checks 
L Loco: bets 400
kenocathy: folds 
Morcold: folds 
L Loco collected 1200 from  pot
L Loco: doesn't show hand 
*** SUMMARY ***
Total pot 1200 | Rake 0 
Board [8h 9s 8d]
Seat 1: kenocathy (small blind) folded on the Flop
Seat 2: Morcold (big blind) folded on the Flop
Seat 3: Big Jag folded before Flop (didn't bet)
Seat 4: FLHRIDER folded before Flop (didn't bet)
Seat 5: Starstealer folded before Flop (didn't bet)
Seat 6: L Loco collected (1200)
Seat 7: maq2000 folded before Flop (didn't bet)
Seat 8: turtle folded before Flop (didn't bet)
Seat 9: 1BigDave (button) folded before Flop (didn't bet)

*********** # 103 **************
PokerStars Game #136615532: Tournament #376033, Hold'em Limit - Level VIII (400/800) - 2003/10/05 - 02:02:58 (ET)
Table '376033 11' Seat #1 is the button
Seat 1: kenocathy (4875 in chips) 
Seat 2: Morcold (5980 in chips) 
Seat 3: Big Jag (6959 in chips) 
Seat 4: FLHRIDER (9155 in chips) 
Seat 5: Starstealer (9260 in chips) 
Seat 6: L Loco (7470 in chips) 
Seat 7: maq2000 (7370 in chips) 
Seat 8: turtle (4380 in chips) 
Seat 9: 1BigDave (6830 in chips) 
Morcold: posts small blind 200
Big Jag: posts big blind 400
*** HOLE CARDS ***
Dealt to Starstealer [4s 5d]
FLHRIDER: folds 
Starstealer: folds 
L Loco: folds 
maq2000: folds 
turtle: folds 
1BigDave: raises 400 to 800
kenocathy: folds 
Morcold: folds 
Big Jag: calls 400
*** FLOP *** [Qc Qd Jc]
Big Jag: checks 
1BigDave: bets 400
Big Jag: calls 400
*** TURN *** [Qc Qd Jc] [6c]
Big Jag: checks 
1BigDave: bets 800
Big Jag: calls 800
*** RIVER *** [Qc Qd Jc 6c] [Kd]
Big Jag: checks 
1BigDave: bets 800
Big Jag: calls 800
*** SHOW DOWN ***
1BigDave: shows [Ad Qh] (three of a kind, Queens)
Big Jag: mucks hand 
1BigDave collected 5800 from  pot
*** SUMMARY ***
Total pot 5800 | Rake 0 
Board [Qc Qd Jc 6c Kd]
Seat 1: kenocathy (button) folded before Flop (didn't bet)
Seat 2: Morcold (small blind) folded before Flop
Seat 3: Big Jag (big blind) mucked [Js Ah] - two pair, Queens and Jacks
Seat 4: FLHRIDER folded before Flop (didn't bet)
Seat 5: Starstealer folded before Flop (didn't bet)
Seat 6: L Loco folded before Flop (didn't bet)
Seat 7: maq2000 folded before Flop (didn't bet)
Seat 8: turtle folded before Flop (didn't bet)
Seat 9: 1BigDave showed [Ad Qh] and won (5800) with three of a kind, Queens

*********** # 104 **************
PokerStars Game #136616525: Tournament #376033, Hold'em Limit - Level VIII (400/800) - 2003/10/05 - 02:04:20 (ET)
Table '376033 11' Seat #2 is the button
Seat 1: kenocathy (4875 in chips) 
Seat 2: Morcold (5780 in chips) 
Seat 3: Big Jag (4159 in chips) 
Seat 4: FLHRIDER (9155 in chips) 
Seat 5: Starstealer (9260 in chips) 
Seat 6: L Loco (7470 in chips) 
Seat 7: maq2000 (7370 in chips) 
Seat 8: turtle (4380 in chips) 
Seat 9: 1BigDave (9830 in chips) 
Big Jag: posts small blind 200
FLHRIDER: posts big blind 400
*** HOLE CARDS ***
Dealt to Starstealer [Td 4h]
Starstealer: folds 
L Loco: folds 
maq2000: folds 
turtle: folds 
1BigDave: folds 
kenocathy: calls 400
Morcold: folds 
Big Jag: folds 
FLHRIDER: checks 
*** FLOP *** [9h 7s Ks]
FLHRIDER: bets 400
kenocathy: calls 400
*** TURN *** [9h 7s Ks] [5c]
FLHRIDER: bets 800
kenocathy: folds 
FLHRIDER collected 1800 from  pot
FLHRIDER: doesn't show hand 
*** SUMMARY ***
Total pot 1800 | Rake 0 
Board [9h 7s Ks 5c]
Seat 1: kenocathy folded on the Turn
Seat 2: Morcold (button) folded before Flop (didn't bet)
Seat 3: Big Jag (small blind) folded before Flop
Seat 4: FLHRIDER (big blind) collected (1800)
Seat 5: Starstealer folded before Flop (didn't bet)
Seat 6: L Loco folded before Flop (didn't bet)
Seat 7: maq2000 folded before Flop (didn't bet)
Seat 8: turtle folded before Flop (didn't bet)
Seat 9: 1BigDave folded before Flop (didn't bet)

*********** # 105 **************
PokerStars Game #136617170: Tournament #376033, Hold'em Limit - Level VIII (400/800) - 2003/10/05 - 02:05:13 (ET)
Table '376033 11' Seat #3 is the button
Seat 1: kenocathy (4075 in chips) 
Seat 2: Morcold (5780 in chips) 
Seat 3: Big Jag (3959 in chips) 
Seat 4: FLHRIDER (10155 in chips) 
Seat 5: Starstealer (9260 in chips) 
Seat 6: L Loco (7470 in chips) 
Seat 7: maq2000 (7370 in chips) 
Seat 8: turtle (4380 in chips) 
Seat 9: 1BigDave (9830 in chips) 
FLHRIDER: posts small blind 200
Starstealer: posts big blind 400
*** HOLE CARDS ***
Dealt to Starstealer [Jd Qc]
L Loco: folds 
maq2000: folds 
turtle: folds 
1BigDave: folds 
kenocathy: calls 400
Morcold: folds 
Big Jag: folds 
FLHRIDER: calls 200
Starstealer: checks 
*** FLOP *** [Qh 3h 6s]
FLHRIDER: bets 400
Starstealer: calls 400
L Loco is sitting out
kenocathy: calls 400
*** TURN *** [Qh 3h 6s] [Jh]
turtle is sitting out
FLHRIDER: checks 
Starstealer: bets 800
kenocathy: calls 800
FLHRIDER: calls 800
*** RIVER *** [Qh 3h 6s Jh] [3s]
Big Jag is sitting out
FLHRIDER: bets 800
Starstealer: calls 800
kenocathy: raises 800 to 1600
FLHRIDER: calls 800
Starstealer: calls 800
*** SHOW DOWN ***
kenocathy: shows [3d 3c] (four of a kind, Threes)
FLHRIDER: mucks hand 
Starstealer: mucks hand 
kenocathy collected 9600 from  pot
Starstealer said, "nh"
FLHRIDER said, "vnh"
*** SUMMARY ***
Total pot 9600 | Rake 0 
Board [Qh 3h 6s Jh 3s]
Seat 1: kenocathy showed [3d 3c] and won (9600) with four of a kind, Threes
Seat 2: Morcold folded before Flop (didn't bet)
Seat 3: Big Jag (button) folded before Flop (didn't bet)
Seat 4: FLHRIDER (small blind) mucked [6d 6c] - a full house, Sixes full of Threes
Seat 5: Starstealer (big blind) mucked [Jd Qc] - two pair, Queens and Jacks
Seat 6: L Loco folded before Flop (didn't bet)
Seat 7: maq2000 folded before Flop (didn't bet)
Seat 8: turtle folded before Flop (didn't bet)
Seat 9: 1BigDave folded before Flop (didn't bet)

*********** # 106 **************
PokerStars Game #136621870: Tournament #376033, Hold'em Limit - Level IX (600/1200) - 2003/10/05 - 02:11:47 (ET)
Table '376033 11' Seat #4 is the button
Seat 1: kenocathy (10475 in chips) 
Seat 2: Morcold (5780 in chips) 
Seat 3: Big Jag (3959 in chips) 
Seat 4: FLHRIDER (6955 in chips) 
Seat 5: Starstealer (6060 in chips) 
Seat 6: L Loco (7470 in chips) 
Seat 7: maq2000 (7370 in chips) 
Seat 8: turtle (4380 in chips) 
Seat 9: 1BigDave (9830 in chips) 
Starstealer: posts small blind 300
L Loco: posts big blind 600
*** HOLE CARDS ***
Dealt to Starstealer [6h 5h]
maq2000: folds 
turtle: folds 
1BigDave: folds 
kenocathy: folds 
Morcold: folds 
Big Jag: calls 600
FLHRIDER: calls 600
Starstealer: folds 
L Loco: checks 
*** FLOP *** [7h As 7s]
L Loco: checks 
Big Jag: checks 
FLHRIDER: checks 
*** TURN *** [7h As 7s] [Js]
L Loco: bets 1200
Big Jag: calls 1200
FLHRIDER: folds 
*** RIVER *** [7h As 7s Js] [5d]
L Loco: bets 1200
Big Jag: folds 
L Loco collected 4500 from  pot
L Loco: doesn't show hand 
*** SUMMARY ***
Total pot 4500 | Rake 0 
Board [7h As 7s Js 5d]
Seat 1: kenocathy folded before Flop (didn't bet)
Seat 2: Morcold folded before Flop (didn't bet)
Seat 3: Big Jag folded on the River
Seat 4: FLHRIDER (button) folded on the Turn
Seat 5: Starstealer (small blind) folded before Flop
Seat 6: L Loco (big blind) collected (4500)
Seat 7: maq2000 folded before Flop (didn't bet)
Seat 8: turtle folded before Flop (didn't bet)
Seat 9: 1BigDave folded before Flop (didn't bet)

*********** # 107 **************
PokerStars Game #136622860: Tournament #376033, Hold'em Limit - Level IX (600/1200) - 2003/10/05 - 02:13:08 (ET)
Table '376033 11' Seat #5 is the button
Seat 1: kenocathy (10475 in chips) 
Seat 2: Morcold (5780 in chips) 
Seat 3: Big Jag (2159 in chips) 
Seat 4: FLHRIDER (6355 in chips) 
Seat 5: Starstealer (5760 in chips) 
Seat 6: L Loco (10170 in chips) 
Seat 7: maq2000 (7370 in chips) 
Seat 8: turtle (4380 in chips) 
Seat 9: 1BigDave (9830 in chips) 
L Loco: posts small blind 300
maq2000: posts big blind 600
*** HOLE CARDS ***
Dealt to Starstealer [Tc 3h]
turtle: folds 
1BigDave: folds 
kenocathy: folds 
Morcold: folds 
Big Jag: folds 
FLHRIDER: folds 
Starstealer: folds 
L Loco: folds 
maq2000 collected 600 from  pot
maq2000: doesn't show hand 
*** SUMMARY ***
Total pot 600 | Rake 0 
Seat 1: kenocathy folded before Flop (didn't bet)
Seat 2: Morcold folded before Flop (didn't bet)
Seat 3: Big Jag folded before Flop (didn't bet)
Seat 4: FLHRIDER folded before Flop (didn't bet)
Seat 5: Starstealer (button) folded before Flop (didn't bet)
Seat 6: L Loco (small blind) folded before Flop
Seat 7: maq2000 (big blind) collected (600)
Seat 8: turtle folded before Flop (didn't bet)
Seat 9: 1BigDave folded before Flop (didn't bet)

*********** # 108 **************
PokerStars Game #136623098: Tournament #376033, Hold'em Limit - Level IX (600/1200) - 2003/10/05 - 02:13:29 (ET)
Table '376033 11' Seat #6 is the button
Seat 1: kenocathy (10475 in chips) 
Seat 2: Morcold (5780 in chips) 
Seat 3: Big Jag (2159 in chips) 
Seat 4: FLHRIDER (6355 in chips) 
Seat 5: Starstealer (5760 in chips) 
Seat 6: L Loco (9870 in chips) 
Seat 7: maq2000 (7670 in chips) 
Seat 8: turtle (4380 in chips) 
Seat 9: 1BigDave (9830 in chips) 
maq2000: posts small blind 300
turtle: posts big blind 600
*** HOLE CARDS ***
Dealt to Starstealer [7d 7s]
1BigDave: folds 
kenocathy: folds 
Morcold: folds 
Big Jag: folds 
FLHRIDER: calls 600
Starstealer: raises 600 to 1200
L Loco: folds 
maq2000: folds 
turtle: folds 
FLHRIDER: calls 600
*** FLOP *** [4c Js 3s]
FLHRIDER: checks 
Starstealer: bets 600
FLHRIDER: calls 600
*** TURN *** [4c Js 3s] [9c]
FLHRIDER: checks 
Starstealer: bets 1200
FLHRIDER: folds 
Starstealer collected 4500 from  pot
Starstealer: doesn't show hand 
*** SUMMARY ***
Total pot 4500 | Rake 0 
Board [4c Js 3s 9c]
Seat 1: kenocathy folded before Flop (didn't bet)
Seat 2: Morcold folded before Flop (didn't bet)
Seat 3: Big Jag folded before Flop (didn't bet)
Seat 4: FLHRIDER folded on the Turn
Seat 5: Starstealer collected (4500)
Seat 6: L Loco (button) folded before Flop (didn't bet)
Seat 7: maq2000 (small blind) folded before Flop
Seat 8: turtle (big blind) folded before Flop
Seat 9: 1BigDave folded before Flop (didn't bet)

*********** # 109 **************
PokerStars Game #136623844: Tournament #376033, Hold'em Limit - Level IX (600/1200) - 2003/10/05 - 02:14:32 (ET)
Table '376033 11' Seat #7 is the button
Seat 1: kenocathy (10475 in chips) 
Seat 2: Morcold (5780 in chips) 
Seat 3: Big Jag (2159 in chips) 
Seat 4: FLHRIDER (4555 in chips) 
Seat 5: Starstealer (8460 in chips) 
Seat 6: L Loco (9870 in chips) 
Seat 7: maq2000 (7370 in chips) 
Seat 8: turtle (3780 in chips) 
Seat 9: 1BigDave (9830 in chips) 
turtle: posts small blind 300
1BigDave: posts big blind 600
*** HOLE CARDS ***
Dealt to Starstealer [Ks Js]
kenocathy: folds 
Morcold: calls 600
Big Jag: folds 
FLHRIDER: folds 
Starstealer: folds 
L Loco: folds 
maq2000: folds 
turtle: calls 300
1BigDave: checks 
*** FLOP *** [2d 4h 5s]
turtle: checks 
1BigDave: bets 600
Morcold: calls 600
turtle: folds 
*** TURN *** [2d 4h 5s] [9d]
1BigDave: bets 1200
Morcold: folds 
1BigDave collected 3000 from  pot
1BigDave: doesn't show hand 
*** SUMMARY ***
Total pot 3000 | Rake 0 
Board [2d 4h 5s 9d]
Seat 1: kenocathy folded before Flop (didn't bet)
Seat 2: Morcold folded on the Turn
Seat 3: Big Jag folded before Flop (didn't bet)
Seat 4: FLHRIDER folded before Flop (didn't bet)
Seat 5: Starstealer folded before Flop (didn't bet)
Seat 6: L Loco folded before Flop (didn't bet)
Seat 7: maq2000 (button) folded before Flop (didn't bet)
Seat 8: turtle (small blind) folded on the Flop
Seat 9: 1BigDave (big blind) collected (3000)

*********** # 110 **************
PokerStars Game #136624616: Tournament #376033, Hold'em Limit - Level IX (600/1200) - 2003/10/05 - 02:15:36 (ET)
Table '376033 11' Seat #8 is the button
Seat 1: kenocathy (10475 in chips) 
Seat 2: Morcold (4580 in chips) 
Seat 3: Big Jag (2159 in chips) 
Seat 4: FLHRIDER (4555 in chips) 
Seat 5: Starstealer (8460 in chips) 
Seat 6: L Loco (9870 in chips) 
Seat 7: maq2000 (7370 in chips) 
Seat 8: turtle (3180 in chips) 
Seat 9: 1BigDave (11630 in chips) 
1BigDave: posts small blind 300
kenocathy: posts big blind 600
*** HOLE CARDS ***
Dealt to Starstealer [4s Ah]
Morcold: calls 600
Big Jag: folds 
FLHRIDER: folds 
Starstealer: folds 
L Loco: calls 600
maq2000: folds 
turtle: folds 
1BigDave: folds 
kenocathy: checks 
*** FLOP *** [Kc 4d Jh]
kenocathy: checks 
Morcold: checks 
L Loco: checks 
*** TURN *** [Kc 4d Jh] [Ad]
kenocathy: checks 
Morcold: bets 1200
L Loco: raises 1200 to 2400
kenocathy: calls 2400
Morcold: folds 
*** RIVER *** [Kc 4d Jh Ad] [Ac]
kenocathy: bets 1200
L Loco: calls 1200
*** SHOW DOWN ***
kenocathy: shows [5h As] (three of a kind, Aces)
L Loco: shows [Qd Tc] (a straight, Ten to Ace)
L Loco collected 10500 from  pot
*** SUMMARY ***
Total pot 10500 | Rake 0 
Board [Kc 4d Jh Ad Ac]
Seat 1: kenocathy (big blind) showed [5h As] and lost with three of a kind, Aces
Seat 2: Morcold folded on the Turn
Seat 3: Big Jag folded before Flop (didn't bet)
Seat 4: FLHRIDER folded before Flop (didn't bet)
Seat 5: Starstealer folded before Flop (didn't bet)
Seat 6: L Loco showed [Qd Tc] and won (10500) with a straight, Ten to Ace
Seat 7: maq2000 folded before Flop (didn't bet)
Seat 8: turtle (button) folded before Flop (didn't bet)
Seat 9: 1BigDave (small blind) folded before Flop

*********** # 111 **************
PokerStars Game #136625711: Tournament #376033, Hold'em Limit - Level IX (600/1200) - 2003/10/05 - 02:17:13 (ET)
Table '376033 11' Seat #9 is the button
Seat 1: kenocathy (6275 in chips) 
Seat 2: Morcold (2780 in chips) 
Seat 3: Big Jag (2159 in chips) 
Seat 4: FLHRIDER (4555 in chips) 
Seat 5: Starstealer (8460 in chips) 
Seat 6: L Loco (16170 in chips) 
Seat 7: maq2000 (7370 in chips) 
Seat 8: turtle (3180 in chips) 
Seat 9: 1BigDave (11330 in chips) 
kenocathy: posts small blind 300
Morcold: posts big blind 600
*** HOLE CARDS ***
Dealt to Starstealer [Kh 5h]
Big Jag: calls 600
FLHRIDER: folds 
Starstealer: folds 
L Loco: folds 
maq2000: folds 
turtle: folds 
1BigDave: folds 
kenocathy: folds 
Morcold: checks 
*** FLOP *** [8d 5s 3c]
Morcold: bets 600
Big Jag: calls 600
*** TURN *** [8d 5s 3c] [Js]
Morcold: checks 
Big Jag: checks 
*** RIVER *** [8d 5s 3c Js] [As]
Morcold: checks 
Big Jag: checks 
*** SHOW DOWN ***
Morcold: shows [6h 7c] (high card Ace)
Big Jag: shows [Ks Qc] (high card Ace - King kicker)
Big Jag collected 2700 from  pot
*** SUMMARY ***
Total pot 2700 | Rake 0 
Board [8d 5s 3c Js As]
Seat 1: kenocathy (small blind) folded before Flop
Seat 2: Morcold (big blind) showed [6h 7c] and lost with high card Ace
Seat 3: Big Jag showed [Ks Qc] and won (2700) with high card Ace
Seat 4: FLHRIDER folded before Flop (didn't bet)
Seat 5: Starstealer folded before Flop (didn't bet)
Seat 6: L Loco folded before Flop (didn't bet)
Seat 7: maq2000 folded before Flop (didn't bet)
Seat 8: turtle folded before Flop (didn't bet)
Seat 9: 1BigDave (button) folded before Flop (didn't bet)

*********** # 112 **************
PokerStars Game #136626407: Tournament #376033, Hold'em Limit - Level IX (600/1200) - 2003/10/05 - 02:18:10 (ET)
Table '376033 11' Seat #1 is the button
Seat 1: kenocathy (5975 in chips) 
Seat 2: Morcold (1580 in chips) 
Seat 3: Big Jag (3659 in chips) 
Seat 4: FLHRIDER (4555 in chips) 
Seat 5: Starstealer (8460 in chips) 
Seat 6: L Loco (16170 in chips) 
Seat 7: maq2000 (7370 in chips) 
Seat 8: turtle (3180 in chips) 
Seat 9: 1BigDave (11330 in chips) 
Morcold: posts small blind 300
Big Jag: posts big blind 600
*** HOLE CARDS ***
Dealt to Starstealer [9d 7s]
FLHRIDER: folds 
Starstealer: folds 
L Loco: folds 
maq2000: folds 
turtle: calls 600
1BigDave: raises 600 to 1200
kenocathy: folds 
Morcold: calls 900
Big Jag: folds 
turtle: calls 600
*** FLOP *** [Th 9s 7d]
Morcold: checks 
turtle: bets 600
1BigDave: raises 600 to 1200
Morcold: folds 
turtle: calls 600
*** TURN *** [Th 9s 7d] [Kh]
turtle: checks 
1BigDave: bets 1200
turtle: calls 780 and is all-in
*** RIVER *** [Th 9s 7d Kh] [4h]
*** SHOW DOWN ***
turtle: shows [Qs As] (high card Ace)
1BigDave: shows [Js Jd] (a pair of Jacks)
1BigDave collected 8160 from  pot
*** SUMMARY ***
Total pot 8160 | Rake 0 
Board [Th 9s 7d Kh 4h]
Seat 1: kenocathy (button) folded before Flop (didn't bet)
Seat 2: Morcold (small blind) folded on the Flop
Seat 3: Big Jag (big blind) folded before Flop
Seat 4: FLHRIDER folded before Flop (didn't bet)
Seat 5: Starstealer folded before Flop (didn't bet)
Seat 6: L Loco folded before Flop (didn't bet)
Seat 7: maq2000 folded before Flop (didn't bet)
Seat 8: turtle showed [Qs As] and lost with high card Ace
Seat 9: 1BigDave showed [Js Jd] and won (8160) with a pair of Jacks

*********** # 113 **************
PokerStars Game #136627113: Tournament #376033, Hold'em Limit - Level IX (600/1200) - 2003/10/05 - 02:19:12 (ET)
Table '376033 11' Seat #2 is the button
Seat 1: kenocathy (5975 in chips) 
Seat 2: Morcold (380 in chips) 
Seat 3: Big Jag (3059 in chips) 
Seat 4: FLHRIDER (4555 in chips) 
Seat 5: Starstealer (8460 in chips) 
Seat 6: L Loco (16170 in chips) 
Seat 7: maq2000 (7370 in chips) 
Seat 9: 1BigDave (16310 in chips) 
Big Jag: posts small blind 300
FLHRIDER: posts big blind 600
*** HOLE CARDS ***
Dealt to Starstealer [5c Jh]
Starstealer: folds 
L Loco: folds 
maq2000: folds 
1BigDave: folds 
kenocathy: calls 600
Morcold: calls 380 and is all-in
Big Jag: folds 
FLHRIDER: checks 
*** FLOP *** [4c Ts 9h]
FLHRIDER: checks 
kenocathy: checks 
*** TURN *** [4c Ts 9h] [Th]
FLHRIDER: checks 
kenocathy: checks 
*** RIVER *** [4c Ts 9h Th] [5d]
FLHRIDER: checks 
kenocathy: checks 
*** SHOW DOWN ***
FLHRIDER: shows [2c Ah] (a pair of Tens)
kenocathy: shows [Ad Ks] (a pair of Tens - King kicker)
kenocathy collected 440 from side pot
Morcold: shows [Tc Jc] (three of a kind, Tens)
Morcold collected 1440 from main pot
*** SUMMARY ***
Total pot 1880 Main pot 1440. Side pot 440. | Rake 0 
Board [4c Ts 9h Th 5d]
Seat 1: kenocathy showed [Ad Ks] and won (440) with a pair of Tens
Seat 2: Morcold (button) showed [Tc Jc] and won (1440) with three of a kind, Tens
Seat 3: Big Jag (small blind) folded before Flop
Seat 4: FLHRIDER (big blind) showed [2c Ah] and lost with a pair of Tens
Seat 5: Starstealer folded before Flop (didn't bet)
Seat 6: L Loco folded before Flop (didn't bet)
Seat 7: maq2000 folded before Flop (didn't bet)
Seat 9: 1BigDave folded before Flop (didn't bet)

*********** # 114 **************
PokerStars Game #136627755: Tournament #376033, Hold'em Limit - Level IX (600/1200) - 2003/10/05 - 02:20:07 (ET)
Table '376033 11' Seat #3 is the button
Seat 1: kenocathy (5815 in chips) 
Seat 2: Morcold (1440 in chips) 
Seat 3: Big Jag (2759 in chips) 
Seat 4: FLHRIDER (3955 in chips) 
Seat 5: Starstealer (8460 in chips) 
Seat 6: L Loco (16170 in chips) 
Seat 7: maq2000 (7370 in chips) 
Seat 9: 1BigDave (16310 in chips) 
FLHRIDER: posts small blind 300
Starstealer: posts big blind 600
*** HOLE CARDS ***
Dealt to Starstealer [8h Js]
L Loco: folds 
maq2000: folds 
1BigDave: folds 
kenocathy: folds 
Morcold: folds 
Big Jag: calls 600
FLHRIDER: calls 300
Starstealer: checks 
*** FLOP *** [7s Jh 5h]
FLHRIDER: checks 
Starstealer: bets 600
Big Jag: calls 600
FLHRIDER: folds 
*** TURN *** [7s Jh 5h] [2c]
Starstealer: bets 1200
Big Jag: folds 
Starstealer collected 3000 from  pot
Starstealer: doesn't show hand 
*** SUMMARY ***
Total pot 3000 | Rake 0 
Board [7s Jh 5h 2c]
Seat 1: kenocathy folded before Flop (didn't bet)
Seat 2: Morcold folded before Flop (didn't bet)
Seat 3: Big Jag (button) folded on the Turn
Seat 4: FLHRIDER (small blind) folded on the Flop
Seat 5: Starstealer (big blind) collected (3000)
Seat 6: L Loco folded before Flop (didn't bet)
Seat 7: maq2000 folded before Flop (didn't bet)
Seat 9: 1BigDave folded before Flop (didn't bet)

*********** # 115 **************
PokerStars Game #136628459: Tournament #376033, Hold'em Limit - Level IX (600/1200) - 2003/10/05 - 02:21:11 (ET)
Table '376033 11' Seat #4 is the button
Seat 1: kenocathy (5815 in chips) 
Seat 2: Morcold (1440 in chips) 
Seat 3: Big Jag (1559 in chips) 
Seat 4: FLHRIDER (3355 in chips) 
Seat 5: Starstealer (10260 in chips) 
Seat 6: L Loco (16170 in chips) 
Seat 7: maq2000 (7370 in chips) 
Seat 9: 1BigDave (16310 in chips) 
Starstealer: posts small blind 300
L Loco: posts big blind 600
*** HOLE CARDS ***
Dealt to Starstealer [4h 2s]
maq2000: folds 
1BigDave: folds 
kenocathy: folds 
Morcold: calls 600
Big Jag: folds 
FLHRIDER: folds 
Starstealer: folds 
L Loco: checks 
*** FLOP *** [Qd 6c 4s]
L Loco: checks 
Morcold: checks 
*** TURN *** [Qd 6c 4s] [Qh]
L Loco: bets 1200
Morcold: folds 
L Loco collected 1500 from  pot
L Loco: doesn't show hand 
*** SUMMARY ***
Total pot 1500 | Rake 0 
Board [Qd 6c 4s Qh]
Seat 1: kenocathy folded before Flop (didn't bet)
Seat 2: Morcold folded on the Turn
Seat 3: Big Jag folded before Flop (didn't bet)
Seat 4: FLHRIDER (button) folded before Flop (didn't bet)
Seat 5: Starstealer (small blind) folded before Flop
Seat 6: L Loco (big blind) collected (1500)
Seat 7: maq2000 folded before Flop (didn't bet)
Seat 9: 1BigDave folded before Flop (didn't bet)

*********** # 116 **************
PokerStars Game #136629066: Tournament #376033, Hold'em Limit - Level IX (600/1200) - 2003/10/05 - 02:22:01 (ET)
Table '376033 11' Seat #5 is the button
Seat 1: kenocathy (5815 in chips) 
Seat 2: Morcold (840 in chips) 
Seat 3: Big Jag (1559 in chips) 
Seat 4: FLHRIDER (3355 in chips) 
Seat 5: Starstealer (9960 in chips) 
Seat 6: L Loco (17070 in chips) 
Seat 7: maq2000 (7370 in chips) 
Seat 9: 1BigDave (16310 in chips) 
L Loco: posts small blind 300
maq2000: posts big blind 600
*** HOLE CARDS ***
Dealt to Starstealer [9s 7c]
1BigDave: folds 
kenocathy: folds 
Morcold: folds 
Big Jag: raises 600 to 1200
FLHRIDER: folds 
Starstealer: folds 
L Loco: folds 
maq2000: raises 600 to 1800
Big Jag: calls 359 and is all-in
*** FLOP *** [2s 8d Qc]
*** TURN *** [2s 8d Qc] [5h]
*** RIVER *** [2s 8d Qc 5h] [Qs]
*** SHOW DOWN ***
maq2000: shows [Kh Ah] (a pair of Queens)
Big Jag: shows [9h 9c] (two pair, Queens and Nines)
Big Jag collected 3418 from  pot
*** SUMMARY ***
Total pot 3418 | Rake 0 
Board [2s 8d Qc 5h Qs]
Seat 1: kenocathy folded before Flop (didn't bet)
Seat 2: Morcold folded before Flop (didn't bet)
Seat 3: Big Jag showed [9h 9c] and won (3418) with two pair, Queens and Nines
Seat 4: FLHRIDER folded before Flop (didn't bet)
Seat 5: Starstealer (button) folded before Flop (didn't bet)
Seat 6: L Loco (small blind) folded before Flop
Seat 7: maq2000 (big blind) showed [Kh Ah] and lost with a pair of Queens
Seat 9: 1BigDave folded before Flop (didn't bet)

*********** # 117 **************
PokerStars Game #136629553: Tournament #376033, Hold'em Limit - Level IX (600/1200) - 2003/10/05 - 02:22:47 (ET)
Table '376033 11' Seat #6 is the button
Seat 1: kenocathy (5815 in chips) 
Seat 2: Morcold (840 in chips) 
Seat 3: Big Jag (3418 in chips) 
Seat 4: FLHRIDER (3355 in chips) 
Seat 5: Starstealer (9960 in chips) 
Seat 6: L Loco (16770 in chips) 
Seat 7: maq2000 (5811 in chips) 
Seat 9: 1BigDave (16310 in chips) 
maq2000: posts small blind 300
1BigDave: posts big blind 600
*** HOLE CARDS ***
Dealt to Starstealer [2d Tc]
kenocathy said, "gj"
kenocathy: calls 600
Morcold: folds 
Big Jag: folds 
FLHRIDER: calls 600
Starstealer: folds 
L Loco: calls 600
maq2000: folds 
1BigDave: checks 
*** FLOP *** [Ac 6d 3d]
Spyfus is connected 
1BigDave: checks 
kenocathy: checks 
FLHRIDER: bets 600
L Loco: calls 600
1BigDave: folds 
kenocathy: calls 600
*** TURN *** [Ac 6d 3d] [Kc]
kenocathy: checks 
FLHRIDER: checks 
L Loco: bets 1200
kenocathy: folds 
FLHRIDER: raises 955 to 2155 and is all-in
L Loco: calls 955
*** RIVER *** [Ac 6d 3d Kc] [Qd]
*** SHOW DOWN ***
FLHRIDER: shows [6c Ah] (two pair, Aces and Sixes)
L Loco: shows [3h As] (two pair, Aces and Threes)
FLHRIDER collected 8810 from  pot
*** SUMMARY ***
Total pot 8810 | Rake 0 
Board [Ac 6d 3d Kc Qd]
Seat 1: kenocathy folded on the Turn
Seat 2: Morcold folded before Flop (didn't bet)
Seat 3: Big Jag folded before Flop (didn't bet)
Seat 4: FLHRIDER showed [6c Ah] and won (8810) with two pair, Aces and Sixes
Seat 5: Starstealer folded before Flop (didn't bet)
Seat 6: L Loco (button) showed [3h As] and lost with two pair, Aces and Threes
Seat 7: maq2000 (small blind) folded before Flop
Seat 9: 1BigDave (big blind) folded on the Flop

*********** # 118 **************
PokerStars Game #136630870: Tournament #376033, Hold'em Limit - Level IX (600/1200) - 2003/10/05 - 02:24:42 (ET)
Table '376033 11' Seat #7 is the button
Seat 1: kenocathy (4615 in chips) 
Seat 2: Morcold (840 in chips) 
Seat 3: Big Jag (3418 in chips) 
Seat 4: FLHRIDER (8810 in chips) 
Seat 5: Starstealer (9960 in chips) 
Seat 6: L Loco (13415 in chips) 
Seat 7: maq2000 (5511 in chips) 
Seat 8: Spyfus (8023 in chips) out of hand (moved from another table into small blind)
Seat 9: 1BigDave (15710 in chips) 
1BigDave: posts small blind 300
kenocathy: posts big blind 600
*** HOLE CARDS ***
Dealt to Starstealer [6h 5d]
Morcold: folds 
Big Jag: folds 
FLHRIDER: calls 600
Starstealer: folds 
L Loco: raises 600 to 1200
maq2000: folds 
1BigDave: folds 
kenocathy: folds 
FLHRIDER: folds 
L Loco collected 2100 from  pot
L Loco: doesn't show hand 
*** SUMMARY ***
Total pot 2100 | Rake 0 
Seat 1: kenocathy (big blind) folded before Flop
Seat 2: Morcold folded before Flop (didn't bet)
Seat 3: Big Jag folded before Flop (didn't bet)
Seat 4: FLHRIDER folded before Flop
Seat 5: Starstealer folded before Flop (didn't bet)
Seat 6: L Loco collected (2100)
Seat 7: maq2000 (button) folded before Flop (didn't bet)
Seat 9: 1BigDave (small blind) folded before Flop

*********** # 119 **************
PokerStars Game #136631294: Tournament #376033, Hold'em Limit - Level IX (600/1200) - 2003/10/05 - 02:25:19 (ET)
Table '376033 11' Seat #9 is the button
Seat 1: kenocathy (4015 in chips) 
Seat 2: Morcold (840 in chips) 
Seat 3: Big Jag (3418 in chips) 
Seat 4: FLHRIDER (8210 in chips) 
Seat 5: Starstealer (9960 in chips) 
Seat 6: L Loco (14915 in chips) 
Seat 7: maq2000 (5511 in chips) 
Seat 8: Spyfus (8023 in chips) 
Seat 9: 1BigDave (15410 in chips) 
kenocathy: posts small blind 300
Morcold: posts big blind 600
*** HOLE CARDS ***
Dealt to Starstealer [Kh 8s]
Big Jag: folds 
FLHRIDER: folds 
Starstealer: folds 
L Loco: calls 600
maq2000: folds 
Spyfus: folds 
1BigDave: folds 
kenocathy: calls 300
Morcold: checks 
*** FLOP *** [As 9c 5s]
kenocathy: checks 
Morcold: checks 
L Loco: checks 
*** TURN *** [As 9c 5s] [Ah]
kenocathy: checks 
Morcold: checks 
L Loco: bets 1200
kenocathy: calls 1200
Morcold: folds 
*** RIVER *** [As 9c 5s Ah] [Qs]
kenocathy: checks 
L Loco: bets 1200
kenocathy: calls 1200
*** SHOW DOWN ***
L Loco: shows [9d Ac] (a full house, Aces full of Nines)
kenocathy: mucks hand 
L Loco collected 6600 from  pot
*** SUMMARY ***
Total pot 6600 | Rake 0 
Board [As 9c 5s Ah Qs]
Seat 1: kenocathy (small blind) mucked [6d Jd] - a pair of Aces
Seat 2: Morcold (big blind) folded on the Turn
Seat 3: Big Jag folded before Flop (didn't bet)
Seat 4: FLHRIDER folded before Flop (didn't bet)
Seat 5: Starstealer folded before Flop (didn't bet)
Seat 6: L Loco showed [9d Ac] and won (6600) with a full house, Aces full of Nines
Seat 7: maq2000 folded before Flop (didn't bet)
Seat 8: Spyfus folded before Flop (didn't bet)
Seat 9: 1BigDave (button) folded before Flop (didn't bet)

*********** # 120 **************
PokerStars Game #136632387: Tournament #376033, Hold'em Limit - Level X (800/1600) - 2003/10/05 - 02:26:56 (ET)
Table '376033 11' Seat #1 is the button
Seat 1: kenocathy (1015 in chips) 
Seat 2: Morcold (240 in chips) 
Seat 3: Big Jag (3418 in chips) 
Seat 4: FLHRIDER (8210 in chips) 
Seat 5: Starstealer (9960 in chips) 
Seat 6: L Loco (18515 in chips) 
Seat 7: maq2000 (5511 in chips) 
Seat 8: Spyfus (8023 in chips) 
Seat 9: 1BigDave (15410 in chips) 
Morcold: posts small blind 240 and is all-in
Big Jag: posts big blind 800
*** HOLE CARDS ***
Dealt to Starstealer [5s Ks]
FLHRIDER: calls 800
Starstealer: folds 
L Loco: folds 
maq2000: folds 
Spyfus: folds 
1BigDave: folds 
kenocathy: folds 
Big Jag: checks 
*** FLOP *** [5d 3d 9c]
Big Jag: checks 
FLHRIDER: checks 
*** TURN *** [5d 3d 9c] [8h]
Big Jag: bets 1600
FLHRIDER: folds 
*** RIVER *** [5d 3d 9c 8h] [Td]
*** SHOW DOWN ***
Big Jag: shows [3h Ad] (a pair of Threes)
Big Jag collected 1120 from side pot
Morcold: shows [2s 2c] (a pair of Deuces)
Big Jag collected 720 from main pot
*** SUMMARY ***
Total pot 1840 Main pot 720. Side pot 1120. | Rake 0 
Board [5d 3d 9c 8h Td]
Seat 1: kenocathy (button) folded before Flop (didn't bet)
Seat 2: Morcold (small blind) showed [2s 2c] and lost with a pair of Deuces
Seat 3: Big Jag (big blind) showed [3h Ad] and won (1840) with a pair of Threes
Seat 4: FLHRIDER folded on the Turn
Seat 5: Starstealer folded before Flop (didn't bet)
Seat 6: L Loco folded before Flop (didn't bet)
Seat 7: maq2000 folded before Flop (didn't bet)
Seat 8: Spyfus folded before Flop (didn't bet)
Seat 9: 1BigDave folded before Flop (didn't bet)

*********** # 121 **************
PokerStars Game #136633061: Tournament #376033, Hold'em Limit - Level X (800/1600) - 2003/10/05 - 02:27:57 (ET)
Table '376033 11' Seat #3 is the button
Seat 1: kenocathy (1015 in chips) 
Seat 3: Big Jag (4458 in chips) 
Seat 4: FLHRIDER (7410 in chips) 
Seat 5: Starstealer (9960 in chips) 
Seat 6: L Loco (18515 in chips) 
Seat 7: maq2000 (5511 in chips) 
Seat 8: Spyfus (8023 in chips) 
Seat 9: 1BigDave (15410 in chips) 
FLHRIDER: posts small blind 400
Starstealer: posts big blind 800
*** HOLE CARDS ***
Dealt to Starstealer [Ac Ts]
L Loco: folds 
maq2000: folds 
Spyfus: folds 
1BigDave: raises 800 to 1600
kenocathy: calls 1015 and is all-in
Big Jag: folds 
FLHRIDER: folds 
Starstealer: calls 800
*** FLOP *** [2s 4d 6d]
Starstealer: checks 
1BigDave: bets 800
Starstealer: folds 
*** TURN *** [2s 4d 6d] [6h]
*** RIVER *** [2s 4d 6d 6h] [Kd]
*** SHOW DOWN ***
1BigDave: shows [4h 4c] (a full house, Fours full of Sixes)
1BigDave collected 1170 from side pot
kenocathy: shows [Qd 3d] (a flush, King high)
1BigDave collected 3445 from main pot
*** SUMMARY ***
Total pot 4615 Main pot 3445. Side pot 1170. | Rake 0 
Board [2s 4d 6d 6h Kd]
Seat 1: kenocathy showed [Qd 3d] and lost with a flush, King high
Seat 3: Big Jag (button) folded before Flop (didn't bet)
Seat 4: FLHRIDER (small blind) folded before Flop
Seat 5: Starstealer (big blind) folded on the Flop
Seat 6: L Loco folded before Flop (didn't bet)
Seat 7: maq2000 folded before Flop (didn't bet)
Seat 8: Spyfus folded before Flop (didn't bet)
Seat 9: 1BigDave showed [4h 4c] and won (4615) with a full house, Fours full of Sixes

*********** # 122 **************
PokerStars Game #136633946: Tournament #376033, Hold'em Limit - Level X (800/1600) - 2003/10/05 - 02:29:18 (ET)
Table '376033 11' Seat #4 is the button
Seat 3: Big Jag (4458 in chips) 
Seat 4: FLHRIDER (7010 in chips) 
Seat 5: Starstealer (8360 in chips) 
Seat 6: L Loco (18515 in chips) 
Seat 7: maq2000 (5511 in chips) 
Seat 8: Spyfus (8023 in chips) 
Seat 9: 1BigDave (18425 in chips) 
Starstealer: posts small blind 400
L Loco: posts big blind 800
*** HOLE CARDS ***
Dealt to Starstealer [9s 4c]
maq2000: folds 
Spyfus: raises 800 to 1600
1BigDave: folds 
Big Jag: calls 1600
FLHRIDER: folds 
Starstealer: folds 
L Loco: folds 
*** FLOP *** [Ac Qc Kh]
MrsConcrete is connected 
Spyfus: bets 800
Big Jag: calls 800
*** TURN *** [Ac Qc Kh] [7d]
Spyfus: checks 
Big Jag: bets 1600
Spyfus: folds 
Big Jag collected 6000 from  pot
Big Jag: doesn't show hand 
*** SUMMARY ***
Total pot 6000 | Rake 0 
Board [Ac Qc Kh 7d]
Seat 3: Big Jag collected (6000)
Seat 4: FLHRIDER (button) folded before Flop (didn't bet)
Seat 5: Starstealer (small blind) folded before Flop
Seat 6: L Loco (big blind) folded before Flop
Seat 7: maq2000 folded before Flop (didn't bet)
Seat 8: Spyfus folded on the Turn
Seat 9: 1BigDave folded before Flop (didn't bet)

*********** # 123 **************
PokerStars Game #136634469: Tournament #376033, Hold'em Limit - Level X (800/1600) - 2003/10/05 - 02:30:07 (ET)
Table '376033 11' Seat #5 is the button
Seat 1: MrsConcrete (17104 in chips) 
Seat 3: Big Jag (8058 in chips) 
Seat 4: FLHRIDER (7010 in chips) 
Seat 5: Starstealer (7960 in chips) 
Seat 6: L Loco (17715 in chips) 
Seat 7: maq2000 (5511 in chips) 
Seat 8: Spyfus (5623 in chips) 
Seat 9: 1BigDave (18425 in chips) 
L Loco: posts small blind 400
maq2000: posts big blind 800
*** HOLE CARDS ***
Dealt to Starstealer [4s Ks]
Spyfus: folds 
1BigDave: folds 
MrsConcrete: folds 
Big Jag: folds 
FLHRIDER: folds 
Starstealer: folds 
L Loco: folds 
maq2000 collected 800 from  pot
maq2000: doesn't show hand 
*** SUMMARY ***
Total pot 800 | Rake 0 
Seat 1: MrsConcrete folded before Flop (didn't bet)
Seat 3: Big Jag folded before Flop (didn't bet)
Seat 4: FLHRIDER folded before Flop (didn't bet)
Seat 5: Starstealer (button) folded before Flop (didn't bet)
Seat 6: L Loco (small blind) folded before Flop
Seat 7: maq2000 (big blind) collected (800)
Seat 8: Spyfus folded before Flop (didn't bet)
Seat 9: 1BigDave folded before Flop (didn't bet)

*********** # 124 **************
PokerStars Game #136634792: Tournament #376033, Hold'em Limit - Level X (800/1600) - 2003/10/05 - 02:30:37 (ET)
Table '376033 11' Seat #6 is the button
Seat 1: MrsConcrete (17104 in chips) 
Seat 3: Big Jag (8058 in chips) 
Seat 4: FLHRIDER (7010 in chips) 
Seat 5: Starstealer (7960 in chips) 
Seat 6: L Loco (17315 in chips) 
Seat 7: maq2000 (5911 in chips) 
Seat 8: Spyfus (5623 in chips) 
Seat 9: 1BigDave (18425 in chips) 
maq2000: posts small blind 400
Spyfus: posts big blind 800
*** HOLE CARDS ***
Dealt to Starstealer [Jd Kc]
1BigDave: folds 
MrsConcrete: folds 
Big Jag: folds 
FLHRIDER: calls 800
Starstealer: folds 
L Loco: folds 
maq2000: folds 
Spyfus: checks 
*** FLOP *** [7d 6c 2h]
Spyfus: bets 800
FLHRIDER: calls 800
*** TURN *** [7d 6c 2h] [4c]
Spyfus: checks 
FLHRIDER: checks 
*** RIVER *** [7d 6c 2h 4c] [5c]
Spyfus: checks 
FLHRIDER: checks 
*** SHOW DOWN ***
Spyfus: shows [8c 5s] (a straight, Four to Eight)
FLHRIDER: mucks hand 
Spyfus collected 3600 from  pot
*** SUMMARY ***
Total pot 3600 | Rake 0 
Board [7d 6c 2h 4c 5c]
Seat 1: MrsConcrete folded before Flop (didn't bet)
Seat 3: Big Jag folded before Flop (didn't bet)
Seat 4: FLHRIDER mucked [Kd 9d] - high card King
Seat 5: Starstealer folded before Flop (didn't bet)
Seat 6: L Loco (button) folded before Flop (didn't bet)
Seat 7: maq2000 (small blind) folded before Flop
Seat 8: Spyfus (big blind) showed [8c 5s] and won (3600) with a straight, Four to Eight
Seat 9: 1BigDave folded before Flop (didn't bet)

*********** # 125 **************
PokerStars Game #136635340: Tournament #376033, Hold'em Limit - Level X (800/1600) - 2003/10/05 - 02:31:29 (ET)
Table '376033 11' Seat #7 is the button
Seat 1: MrsConcrete (17104 in chips) 
Seat 3: Big Jag (8058 in chips) 
Seat 4: FLHRIDER (5410 in chips) 
Seat 5: Starstealer (7960 in chips) 
Seat 6: L Loco (17315 in chips) 
Seat 7: maq2000 (5511 in chips) 
Seat 8: Spyfus (7623 in chips) 
Seat 9: 1BigDave (18425 in chips) 
Spyfus: posts small blind 400
1BigDave: posts big blind 800
*** HOLE CARDS ***
Dealt to Starstealer [Ts 2c]
MrsConcrete: folds 
Big Jag: folds 
FLHRIDER: folds 
Starstealer: folds 
L Loco: calls 800
maq2000: folds 
Spyfus: folds 
1BigDave: checks 
*** FLOP *** [7s Jh Th]
1BigDave: bets 800
L Loco: calls 800
*** TURN *** [7s Jh Th] [6d]
1BigDave: checks 
L Loco: checks 
*** RIVER *** [7s Jh Th 6d] [Ad]
1BigDave: bets 1600
L Loco: calls 1600
*** SHOW DOWN ***
1BigDave: shows [Qh As] (a pair of Aces)
L Loco: shows [7c Ah] (two pair, Aces and Sevens)
L Loco collected 6800 from  pot
*** SUMMARY ***
Total pot 6800 | Rake 0 
Board [7s Jh Th 6d Ad]
Seat 1: MrsConcrete folded before Flop (didn't bet)
Seat 3: Big Jag folded before Flop (didn't bet)
Seat 4: FLHRIDER folded before Flop (didn't bet)
Seat 5: Starstealer folded before Flop (didn't bet)
Seat 6: L Loco showed [7c Ah] and won (6800) with two pair, Aces and Sevens
Seat 7: maq2000 (button) folded before Flop (didn't bet)
Seat 8: Spyfus (small blind) folded before Flop
Seat 9: 1BigDave (big blind) showed [Qh As] and lost with a pair of Aces

*********** # 126 **************
PokerStars Game #136635932: Tournament #376033, Hold'em Limit - Level X (800/1600) - 2003/10/05 - 02:32:23 (ET)
Table '376033 11' Seat #8 is the button
Seat 1: MrsConcrete (17104 in chips) 
Seat 3: Big Jag (8058 in chips) 
Seat 4: FLHRIDER (5410 in chips) 
Seat 5: Starstealer (7960 in chips) 
Seat 6: L Loco (20915 in chips) 
Seat 7: maq2000 (5511 in chips) 
Seat 8: Spyfus (7223 in chips) 
Seat 9: 1BigDave (15225 in chips) 
1BigDave: posts small blind 400
MrsConcrete: posts big blind 800
*** HOLE CARDS ***
Dealt to Starstealer [9s Tc]
tookdawg2000 is connected 
Big Jag: raises 800 to 1600
FLHRIDER: folds 
Starstealer: folds 
L Loco: folds 
maq2000: folds 
Spyfus: folds 
1BigDave: folds 
MrsConcrete: folds 
Big Jag collected 2000 from  pot
Big Jag: doesn't show hand 
*** SUMMARY ***
Total pot 2000 | Rake 0 
Seat 1: MrsConcrete (big blind) folded before Flop
Seat 3: Big Jag collected (2000)
Seat 4: FLHRIDER folded before Flop (didn't bet)
Seat 5: Starstealer folded before Flop (didn't bet)
Seat 6: L Loco folded before Flop (didn't bet)
Seat 7: maq2000 folded before Flop (didn't bet)
Seat 8: Spyfus (button) folded before Flop (didn't bet)
Seat 9: 1BigDave (small blind) folded before Flop

*********** # 127 **************
PokerStars Game #136636331: Tournament #376033, Hold'em Limit - Level X (800/1600) - 2003/10/05 - 02:33:02 (ET)
Table '376033 11' Seat #9 is the button
Seat 1: MrsConcrete (16304 in chips) 
Seat 2: tookdawg2000 (24943 in chips) 
Seat 3: Big Jag (9258 in chips) 
Seat 4: FLHRIDER (5410 in chips) 
Seat 5: Starstealer (7960 in chips) 
Seat 6: L Loco (20915 in chips) 
Seat 7: maq2000 (5511 in chips) 
Seat 8: Spyfus (7223 in chips) 
Seat 9: 1BigDave (14825 in chips) 
MrsConcrete: posts small blind 400
tookdawg2000: posts big blind 800
*** HOLE CARDS ***
Dealt to Starstealer [Ks Jh]
Big Jag: folds 
FLHRIDER: folds 
Starstealer: folds 
L Loco: folds 
maq2000: folds 
Spyfus: folds 
1BigDave: folds 
MrsConcrete: folds 
tookdawg2000 collected 800 from  pot
tookdawg2000: doesn't show hand 
*** SUMMARY ***
Total pot 800 | Rake 0 
Seat 1: MrsConcrete (small blind) folded before Flop
Seat 2: tookdawg2000 (big blind) collected (800)
Seat 3: Big Jag folded before Flop (didn't bet)
Seat 4: FLHRIDER folded before Flop (didn't bet)
Seat 5: Starstealer folded before Flop (didn't bet)
Seat 6: L Loco folded before Flop (didn't bet)
Seat 7: maq2000 folded before Flop (didn't bet)
Seat 8: Spyfus folded before Flop (didn't bet)
Seat 9: 1BigDave (button) folded before Flop (didn't bet)

*********** # 128 **************
PokerStars Game #136636607: Tournament #376033, Hold'em Limit - Level X (800/1600) - 2003/10/05 - 02:33:26 (ET)
Table '376033 11' Seat #1 is the button
Seat 1: MrsConcrete (15904 in chips) 
Seat 2: tookdawg2000 (25343 in chips) 
Seat 3: Big Jag (9258 in chips) 
Seat 4: FLHRIDER (5410 in chips) 
Seat 5: Starstealer (7960 in chips) 
Seat 6: L Loco (20915 in chips) 
Seat 7: maq2000 (5511 in chips) 
Seat 8: Spyfus (7223 in chips) 
Seat 9: 1BigDave (14825 in chips) 
tookdawg2000: posts small blind 400
Big Jag: posts big blind 800
*** HOLE CARDS ***
Dealt to Starstealer [Js 5d]
FLHRIDER: calls 800
Starstealer: folds 
L Loco: folds 
maq2000: raises 800 to 1600
Spyfus: folds 
1BigDave: folds 
MrsConcrete: folds 
tookdawg2000: folds 
Big Jag: calls 800
FLHRIDER: calls 800
*** FLOP *** [2s Kh 7c]
Big Jag: checks 
FLHRIDER: checks 
maq2000: bets 800
Big Jag: raises 800 to 1600
FLHRIDER: folds 
maq2000: folds 
Big Jag collected 6800 from  pot
Big Jag: doesn't show hand 
*** SUMMARY ***
Total pot 6800 | Rake 0 
Board [2s Kh 7c]
Seat 1: MrsConcrete (button) folded before Flop (didn't bet)
Seat 2: tookdawg2000 (small blind) folded before Flop
Seat 3: Big Jag (big blind) collected (6800)
Seat 4: FLHRIDER folded on the Flop
Seat 5: Starstealer folded before Flop (didn't bet)
Seat 6: L Loco folded before Flop (didn't bet)
Seat 7: maq2000 folded on the Flop
Seat 8: Spyfus folded before Flop (didn't bet)
Seat 9: 1BigDave folded before Flop (didn't bet)

*********** # 129 **************
PokerStars Game #136637178: Tournament #376033, Hold'em Limit - Level X (800/1600) - 2003/10/05 - 02:34:21 (ET)
Table '376033 11' Seat #2 is the button
Seat 1: MrsConcrete (15904 in chips) 
Seat 2: tookdawg2000 (24943 in chips) 
Seat 3: Big Jag (13658 in chips) 
Seat 4: FLHRIDER (3810 in chips) 
Seat 5: Starstealer (7960 in chips) 
Seat 6: L Loco (20915 in chips) 
Seat 7: maq2000 (3111 in chips) 
Seat 8: Spyfus (7223 in chips) 
Seat 9: 1BigDave (14825 in chips) 
Big Jag: posts small blind 400
FLHRIDER: posts big blind 800
*** HOLE CARDS ***
Dealt to Starstealer [Ah Tc]
Starstealer: folds 
L Loco: raises 800 to 1600
maq2000: folds 
Spyfus: folds 
1BigDave: folds 
MrsConcrete: folds 
tookdawg2000: folds 
Big Jag: folds 
FLHRIDER: folds 
L Loco collected 2000 from  pot
L Loco: doesn't show hand 
*** SUMMARY ***
Total pot 2000 | Rake 0 
Seat 1: MrsConcrete folded before Flop (didn't bet)
Seat 2: tookdawg2000 (button) folded before Flop (didn't bet)
Seat 3: Big Jag (small blind) folded before Flop
Seat 4: FLHRIDER (big blind) folded before Flop
Seat 5: Starstealer folded before Flop (didn't bet)
Seat 6: L Loco collected (2000)
Seat 7: maq2000 folded before Flop (didn't bet)
Seat 8: Spyfus folded before Flop (didn't bet)
Seat 9: 1BigDave folded before Flop (didn't bet)

*********** # 130 **************
PokerStars Game #136637481: Tournament #376033, Hold'em Limit - Level X (800/1600) - 2003/10/05 - 02:34:48 (ET)
Table '376033 11' Seat #3 is the button
Seat 1: MrsConcrete (15904 in chips) 
Seat 2: tookdawg2000 (24943 in chips) 
Seat 3: Big Jag (13258 in chips) 
Seat 4: FLHRIDER (3010 in chips) 
Seat 5: Starstealer (7960 in chips) 
Seat 6: L Loco (22115 in chips) 
Seat 7: maq2000 (3111 in chips) 
Seat 8: Spyfus (7223 in chips) 
Seat 9: 1BigDave (14825 in chips) 
FLHRIDER: posts small blind 400
Starstealer: posts big blind 800
*** HOLE CARDS ***
Dealt to Starstealer [7d 7c]
L Loco: folds 
maq2000: calls 800
Spyfus: folds 
1BigDave: folds 
MrsConcrete: folds 
tookdawg2000: folds 
Big Jag: folds 
FLHRIDER: calls 400
Starstealer: checks 
*** FLOP *** [Qd 8h 8d]
FLHRIDER: checks 
Starstealer: bets 800
maq2000: folds 
FLHRIDER: calls 800
*** TURN *** [Qd 8h 8d] [6h]
FLHRIDER: checks 
Starstealer: bets 1600
FLHRIDER: folds 
Starstealer collected 4000 from  pot
Starstealer: shows [7d 7c] (two pair, Eights and Sevens)
*** SUMMARY ***
Total pot 4000 | Rake 0 
Board [Qd 8h 8d 6h]
Seat 1: MrsConcrete folded before Flop (didn't bet)
Seat 2: tookdawg2000 folded before Flop (didn't bet)
Seat 3: Big Jag (button) folded before Flop (didn't bet)
Seat 4: FLHRIDER (small blind) folded on the Turn
Seat 5: Starstealer (big blind) collected (4000)
Seat 6: L Loco folded before Flop (didn't bet)
Seat 7: maq2000 folded on the Flop
Seat 8: Spyfus folded before Flop (didn't bet)
Seat 9: 1BigDave folded before Flop (didn't bet)

*********** # 131 **************
PokerStars Game #136638281: Tournament #376033, Hold'em Limit - Level X (800/1600) - 2003/10/05 - 02:36:06 (ET)
Table '376033 11' Seat #4 is the button
Seat 1: MrsConcrete (15904 in chips) 
Seat 2: tookdawg2000 (24943 in chips) 
Seat 3: Big Jag (13258 in chips) 
Seat 4: FLHRIDER (1410 in chips) 
Seat 5: Starstealer (10360 in chips) 
Seat 6: L Loco (22115 in chips) 
Seat 7: maq2000 (2311 in chips) 
Seat 8: Spyfus (7223 in chips) 
Seat 9: 1BigDave (14825 in chips) 
Starstealer: posts small blind 400
L Loco: posts big blind 800
*** HOLE CARDS ***
Dealt to Starstealer [6c Ts]
maq2000: folds 
Spyfus: folds 
1BigDave: folds 
MrsConcrete: folds 
tookdawg2000: calls 800
Big Jag: folds 
FLHRIDER: calls 800
Starstealer: folds 
L Loco: checks 
*** FLOP *** [Qs 3s Ah]
L Loco: checks 
tookdawg2000: checks 
FLHRIDER: checks 
*** TURN *** [Qs 3s Ah] [9d]
L Loco: checks 
tookdawg2000: bets 1600
FLHRIDER: calls 610 and is all-in
L Loco: folds 
*** RIVER *** [Qs 3s Ah 9d] [Qh]
*** SHOW DOWN ***
tookdawg2000: shows [8d 6d] (a pair of Queens)
FLHRIDER: shows [As 2s] (two pair, Aces and Queens)
FLHRIDER collected 4020 from  pot
*** SUMMARY ***
Total pot 4020 | Rake 0 
Board [Qs 3s Ah 9d Qh]
Seat 1: MrsConcrete folded before Flop (didn't bet)
Seat 2: tookdawg2000 showed [8d 6d] and lost with a pair of Queens
Seat 3: Big Jag folded before Flop (didn't bet)
Seat 4: FLHRIDER (button) showed [As 2s] and won (4020) with two pair, Aces and Queens
Seat 5: Starstealer (small blind) folded before Flop
Seat 6: L Loco (big blind) folded on the Turn
Seat 7: maq2000 folded before Flop (didn't bet)
Seat 8: Spyfus folded before Flop (didn't bet)
Seat 9: 1BigDave folded before Flop (didn't bet)

*********** # 132 **************
PokerStars Game #136638950: Tournament #376033, Hold'em Limit - Level X (800/1600) - 2003/10/05 - 02:37:09 (ET)
Table '376033 11' Seat #5 is the button
Seat 1: MrsConcrete (15904 in chips) 
Seat 2: tookdawg2000 (23533 in chips) 
Seat 3: Big Jag (13258 in chips) 
Seat 4: FLHRIDER (4020 in chips) 
Seat 5: Starstealer (9960 in chips) 
Seat 6: L Loco (21315 in chips) 
Seat 7: maq2000 (2311 in chips) 
Seat 8: Spyfus (7223 in chips) 
Seat 9: 1BigDave (14825 in chips) 
L Loco: posts small blind 400
maq2000: posts big blind 800
*** HOLE CARDS ***
Dealt to Starstealer [2h 9s]
Spyfus: folds 
1BigDave: folds 
MrsConcrete: folds 
tookdawg2000: folds 
Big Jag: folds 
FLHRIDER: folds 
Starstealer: folds 
L Loco: folds 
maq2000 collected 800 from  pot
maq2000: doesn't show hand 
*** SUMMARY ***
Total pot 800 | Rake 0 
Seat 1: MrsConcrete folded before Flop (didn't bet)
Seat 2: tookdawg2000 folded before Flop (didn't bet)
Seat 3: Big Jag folded before Flop (didn't bet)
Seat 4: FLHRIDER folded before Flop (didn't bet)
Seat 5: Starstealer (button) folded before Flop (didn't bet)
Seat 6: L Loco (small blind) folded before Flop
Seat 7: maq2000 (big blind) collected (800)
Seat 8: Spyfus folded before Flop (didn't bet)
Seat 9: 1BigDave folded before Flop (didn't bet)

*********** # 133 **************
PokerStars Game #136639193: Tournament #376033, Hold'em Limit - Level X (800/1600) - 2003/10/05 - 02:37:31 (ET)
Table '376033 11' Seat #6 is the button
Seat 1: MrsConcrete (15904 in chips) 
Seat 2: tookdawg2000 (23533 in chips) 
Seat 3: Big Jag (13258 in chips) 
Seat 4: FLHRIDER (4020 in chips) 
Seat 5: Starstealer (9960 in chips) 
Seat 6: L Loco (20915 in chips) 
Seat 7: maq2000 (2711 in chips) 
Seat 8: Spyfus (7223 in chips) 
Seat 9: 1BigDave (14825 in chips) 
maq2000: posts small blind 400
Spyfus: posts big blind 800
*** HOLE CARDS ***
Dealt to Starstealer [5s 7d]
1BigDave: folds 
MrsConcrete: folds 
tookdawg2000: calls 800
Big Jag: folds 
FLHRIDER: calls 800
Starstealer: folds 
L Loco: calls 800
maq2000: calls 400
Spyfus: checks 
*** FLOP *** [2c 3d Kd]
maq2000: bets 800
Spyfus: folds 
tookdawg2000: calls 800
FLHRIDER: calls 800
L Loco: calls 800
*** TURN *** [2c 3d Kd] [8c]
maq2000: bets 1111 and is all-in
tookdawg2000: calls 1111
FLHRIDER: folds 
L Loco: calls 1111
*** RIVER *** [2c 3d Kd 8c] [Jh]
tookdawg2000: checks 
L Loco: checks 
*** SHOW DOWN ***
maq2000: shows [Ks 9c] (a pair of Kings)
tookdawg2000: shows [Kh Qc] (a pair of Kings - Queen kicker)
L Loco: mucks hand 
tookdawg2000 collected 10533 from  pot
*** SUMMARY ***
Total pot 10533 | Rake 0 
Board [2c 3d Kd 8c Jh]
Seat 1: MrsConcrete folded before Flop (didn't bet)
Seat 2: tookdawg2000 showed [Kh Qc] and won (10533) with a pair of Kings
Seat 3: Big Jag folded before Flop (didn't bet)
Seat 4: FLHRIDER folded on the Turn
Seat 5: Starstealer folded before Flop (didn't bet)
Seat 6: L Loco (button) mucked [3c Ac] - a pair of Threes
Seat 7: maq2000 (small blind) showed [Ks 9c] and lost with a pair of Kings
Seat 8: Spyfus (big blind) folded on the Flop
Seat 9: 1BigDave folded before Flop (didn't bet)

*********** # 134 **************
PokerStars Game #136639841: Tournament #376033, Hold'em Limit - Level X (800/1600) - 2003/10/05 - 02:38:33 (ET)
Table '376033 11' Seat #8 is the button
Seat 1: MrsConcrete (15904 in chips) 
Seat 2: tookdawg2000 (31355 in chips) 
Seat 3: Big Jag (13258 in chips) 
Seat 4: FLHRIDER (2420 in chips) 
Seat 5: Starstealer (9960 in chips) 
Seat 6: L Loco (18204 in chips) 
Seat 8: Spyfus (6423 in chips) 
Seat 9: 1BigDave (14825 in chips) 
1BigDave: posts small blind 400
MrsConcrete: posts big blind 800
*** HOLE CARDS ***
Dealt to Starstealer [7d Qd]
tookdawg2000: folds 
Big Jag: folds 
FLHRIDER: calls 800
Starstealer: folds 
L Loco: folds 
Spyfus: folds 
1BigDave: calls 400
MrsConcrete: checks 
*** FLOP *** [9s As 6d]
1BigDave: bets 800
MrsConcrete: folds 
FLHRIDER: folds 
1BigDave collected 2400 from  pot
1BigDave: doesn't show hand 
*** SUMMARY ***
Total pot 2400 | Rake 0 
Board [9s As 6d]
Seat 1: MrsConcrete (big blind) folded on the Flop
Seat 2: tookdawg2000 folded before Flop (didn't bet)
Seat 3: Big Jag folded before Flop (didn't bet)
Seat 4: FLHRIDER folded on the Flop
Seat 5: Starstealer folded before Flop (didn't bet)
Seat 6: L Loco folded before Flop (didn't bet)
Seat 8: Spyfus (button) folded before Flop (didn't bet)
Seat 9: 1BigDave (small blind) collected (2400)

*********** # 135 **************
PokerStars Game #136640209: Tournament #376033, Hold'em Limit - Level X (800/1600) - 2003/10/05 - 02:39:08 (ET)
Table '376033 11' Seat #9 is the button
Seat 1: MrsConcrete (15104 in chips) 
Seat 2: tookdawg2000 (31355 in chips) 
Seat 3: Big Jag (13258 in chips) 
Seat 4: FLHRIDER (1620 in chips) 
Seat 5: Starstealer (9960 in chips) 
Seat 6: L Loco (18204 in chips) 
Seat 8: Spyfus (6423 in chips) 
Seat 9: 1BigDave (16425 in chips) 
MrsConcrete: posts small blind 400
tookdawg2000: posts big blind 800
*** HOLE CARDS ***
Dealt to Starstealer [2d 8c]
Big Jag: folds 
FLHRIDER: folds 
Starstealer: folds 
L Loco: folds 
Spyfus: folds 
1BigDave: folds 
MrsConcrete: calls 400
tookdawg2000: checks 
*** FLOP *** [4s 5c 7s]
MrsConcrete: bets 800
tookdawg2000: raises 800 to 1600
MrsConcrete: calls 800
*** TURN *** [4s 5c 7s] [Ks]
MrsConcrete: checks 
tookdawg2000: bets 1600
MrsConcrete: calls 1600
*** RIVER *** [4s 5c 7s Ks] [Kh]
MrsConcrete: checks 
tookdawg2000: checks 
*** SHOW DOWN ***
MrsConcrete: shows [Js 7h] (two pair, Kings and Sevens)
tookdawg2000: mucks hand 
MrsConcrete collected 8000 from  pot
*** SUMMARY ***
Total pot 8000 | Rake 0 
Board [4s 5c 7s Ks Kh]
Seat 1: MrsConcrete (small blind) showed [Js 7h] and won (8000) with two pair, Kings and Sevens
Seat 2: tookdawg2000 (big blind) mucked [5d 7c] - two pair, Kings and Sevens
Seat 3: Big Jag folded before Flop (didn't bet)
Seat 4: FLHRIDER folded before Flop (didn't bet)
Seat 5: Starstealer folded before Flop (didn't bet)
Seat 6: L Loco folded before Flop (didn't bet)
Seat 8: Spyfus folded before Flop (didn't bet)
Seat 9: 1BigDave (button) folded before Flop (didn't bet)

*********** # 136 **************
PokerStars Game #136640873: Tournament #376033, Hold'em Limit - Level X (800/1600) - 2003/10/05 - 02:40:12 (ET)
Table '376033 11' Seat #1 is the button
Seat 1: MrsConcrete (19104 in chips) 
Seat 2: tookdawg2000 (27355 in chips) 
Seat 3: Big Jag (13258 in chips) 
Seat 4: FLHRIDER (1620 in chips) 
Seat 5: Starstealer (9960 in chips) 
Seat 6: L Loco (18204 in chips) 
Seat 8: Spyfus (6423 in chips) 
Seat 9: 1BigDave (16425 in chips) 
tookdawg2000: posts small blind 400
Big Jag: posts big blind 800
*** HOLE CARDS ***
Dealt to Starstealer [8h As]
FLHRIDER: folds 
Starstealer: folds 
L Loco: folds 
Spyfus: folds 
1BigDave: folds 
MrsConcrete: folds 
tookdawg2000: calls 400
Big Jag: checks 
*** FLOP *** [Ks Kh 4c]
tookdawg2000: bets 800
Big Jag: folds 
tookdawg2000 collected 1600 from  pot
tookdawg2000: doesn't show hand 
*** SUMMARY ***
Total pot 1600 | Rake 0 
Board [Ks Kh 4c]
Seat 1: MrsConcrete (button) folded before Flop (didn't bet)
Seat 2: tookdawg2000 (small blind) collected (1600)
Seat 3: Big Jag (big blind) folded on the Flop
Seat 4: FLHRIDER folded before Flop (didn't bet)
Seat 5: Starstealer folded before Flop (didn't bet)
Seat 6: L Loco folded before Flop (didn't bet)
Seat 8: Spyfus folded before Flop (didn't bet)
Seat 9: 1BigDave folded before Flop (didn't bet)

*********** # 137 **************
PokerStars Game #136641369: Tournament #376033, Hold'em Limit - Level X (800/1600) - 2003/10/05 - 02:40:59 (ET)
Table '376033 11' Seat #2 is the button
Seat 1: MrsConcrete (19104 in chips) 
Seat 2: tookdawg2000 (28155 in chips) 
Seat 3: Big Jag (12458 in chips) 
Seat 4: FLHRIDER (1620 in chips) 
Seat 5: Starstealer (9960 in chips) 
Seat 6: L Loco (18204 in chips) 
Seat 8: Spyfus (6423 in chips) 
Seat 9: 1BigDave (16425 in chips) 
Big Jag: posts small blind 400
FLHRIDER: posts big blind 800
*** HOLE CARDS ***
Dealt to Starstealer [6h 5d]
Starstealer: folds 
L Loco: calls 800
Spyfus: folds 
1BigDave: folds 
MrsConcrete: folds 
tookdawg2000: raises 800 to 1600
Big Jag: folds 
FLHRIDER: folds 
L Loco: calls 800
*** FLOP *** [4h 2s 3c]
L Loco: checks 
tookdawg2000: bets 800
L Loco: folds 
tookdawg2000 collected 4400 from  pot
tookdawg2000: doesn't show hand 
*** SUMMARY ***
Total pot 4400 | Rake 0 
Board [4h 2s 3c]
Seat 1: MrsConcrete folded before Flop (didn't bet)
Seat 2: tookdawg2000 (button) collected (4400)
Seat 3: Big Jag (small blind) folded before Flop
Seat 4: FLHRIDER (big blind) folded before Flop
Seat 5: Starstealer folded before Flop (didn't bet)
Seat 6: L Loco folded on the Flop
Seat 8: Spyfus folded before Flop (didn't bet)
Seat 9: 1BigDave folded before Flop (didn't bet)

*********** # 138 **************
PokerStars Game #136641754: Tournament #376033, Hold'em Limit - Level X (800/1600) - 2003/10/05 - 02:41:35 (ET)
Table '376033 11' Seat #3 is the button
Seat 1: MrsConcrete (19104 in chips) 
Seat 2: tookdawg2000 (30955 in chips) 
Seat 3: Big Jag (12058 in chips) 
Seat 4: FLHRIDER (820 in chips) 
Seat 5: Starstealer (9960 in chips) 
Seat 6: L Loco (16604 in chips) 
Seat 8: Spyfus (6423 in chips) 
Seat 9: 1BigDave (16425 in chips) 
FLHRIDER: posts small blind 400
Starstealer: posts big blind 800
*** HOLE CARDS ***
Dealt to Starstealer [4c Td]
L Loco: calls 800
Spyfus: folds 
1BigDave: folds 
MrsConcrete: folds 
tookdawg2000: folds 
Big Jag: calls 800
FLHRIDER: folds 
Starstealer: checks 
*** FLOP *** [Ac 9h Ks]
Starstealer: checks 
L Loco: checks 
Big Jag: bets 800
Starstealer: folds 
L Loco: folds 
Big Jag collected 2800 from  pot
*** SUMMARY ***
Total pot 2800 | Rake 0 
Board [Ac 9h Ks]
Seat 1: MrsConcrete folded before Flop (didn't bet)
Seat 2: tookdawg2000 folded before Flop (didn't bet)
Seat 3: Big Jag (button) collected (2800)
Seat 4: FLHRIDER (small blind) folded before Flop
Seat 5: Starstealer (big blind) folded on the Flop
Seat 6: L Loco folded on the Flop
Seat 8: Spyfus folded before Flop (didn't bet)
Seat 9: 1BigDave folded before Flop (didn't bet)

*********** # 139 **************
PokerStars Game #136642278: Tournament #376033, Hold'em Limit - Level XI (1200/2400) - 2003/10/05 - 02:42:27 (ET)
Table '376033 11' Seat #4 is the button
Seat 1: MrsConcrete (19104 in chips) 
Seat 2: tookdawg2000 (30955 in chips) 
Seat 3: Big Jag (14058 in chips) 
Seat 4: FLHRIDER (420 in chips) 
Seat 5: Starstealer (9160 in chips) 
Seat 6: L Loco (15804 in chips) 
Seat 8: Spyfus (6423 in chips) 
Seat 9: 1BigDave (16425 in chips) 
Starstealer: posts small blind 600
L Loco: posts big blind 1200
*** HOLE CARDS ***
Dealt to Starstealer [9c 4h]
Spyfus: folds 
1BigDave: raises 1200 to 2400
MrsConcrete: folds 
tookdawg2000: folds 
Big Jag: folds 
FLHRIDER: folds 
Starstealer: folds 
L Loco: calls 1200
*** FLOP *** [7d As 9h]
L Loco: checks 
1BigDave: bets 1200
L Loco: calls 1200
*** TURN *** [7d As 9h] [3d]
L Loco: checks 
1BigDave: checks 
*** RIVER *** [7d As 9h 3d] [4s]
L Loco: bets 2400
1BigDave: calls 2400
*** SHOW DOWN ***
L Loco: shows [Ac 3s] (two pair, Aces and Threes)
1BigDave: mucks hand 
L Loco collected 12600 from  pot
*** SUMMARY ***
Total pot 12600 | Rake 0 
Board [7d As 9h 3d 4s]
Seat 1: MrsConcrete folded before Flop (didn't bet)
Seat 2: tookdawg2000 folded before Flop (didn't bet)
Seat 3: Big Jag folded before Flop (didn't bet)
Seat 4: FLHRIDER (button) folded before Flop (didn't bet)
Seat 5: Starstealer (small blind) folded before Flop
Seat 6: L Loco (big blind) showed [Ac 3s] and won (12600) with two pair, Aces and Threes
Seat 8: Spyfus folded before Flop (didn't bet)
Seat 9: 1BigDave mucked [Js Jd] - a pair of Jacks

*********** # 140 **************
PokerStars Game #136642727: Tournament #376033, Hold'em Limit - Level XI (1200/2400) - 2003/10/05 - 02:43:09 (ET)
Table '376033 11' Seat #5 is the button
Seat 1: MrsConcrete (19104 in chips) 
Seat 2: tookdawg2000 (30955 in chips) 
Seat 3: Big Jag (14058 in chips) 
Seat 4: FLHRIDER (420 in chips) 
Seat 5: Starstealer (8560 in chips) 
Seat 6: L Loco (22404 in chips) 
Seat 8: Spyfus (6423 in chips) 
Seat 9: 1BigDave (10425 in chips) 
L Loco: posts small blind 600
Spyfus: posts big blind 1200
*** HOLE CARDS ***
Dealt to Starstealer [5s 4h]
1BigDave: folds 
MrsConcrete: folds 
tookdawg2000: calls 1200
Big Jag: calls 1200
FLHRIDER has timed out
FLHRIDER: folds 
FLHRIDER is sitting out
Starstealer: folds 
L Loco: folds 
FLHRIDER has returned
Spyfus: checks 
*** FLOP *** [Qh 8c 6d]
Spyfus: checks 
tookdawg2000: bets 1200
Big Jag: folds 
Spyfus: folds 
tookdawg2000 collected 4200 from  pot
tookdawg2000: doesn't show hand 
*** SUMMARY ***
Total pot 4200 | Rake 0 
Board [Qh 8c 6d]
Seat 1: MrsConcrete folded before Flop (didn't bet)
Seat 2: tookdawg2000 collected (4200)
Seat 3: Big Jag folded on the Flop
Seat 4: FLHRIDER folded before Flop (didn't bet)
Seat 5: Starstealer (button) folded before Flop (didn't bet)
Seat 6: L Loco (small blind) folded before Flop
Seat 8: Spyfus (big blind) folded on the Flop
Seat 9: 1BigDave folded before Flop (didn't bet)

*********** # 141 **************
PokerStars Game #136643357: Tournament #376033, Hold'em Limit - Level XI (1200/2400) - 2003/10/05 - 02:44:08 (ET)
Table '376033 11' Seat #6 is the button
Seat 1: MrsConcrete (19104 in chips) 
Seat 2: tookdawg2000 (33955 in chips) 
Seat 3: Big Jag (12858 in chips) 
Seat 4: FLHRIDER (420 in chips) 
Seat 5: Starstealer (8560 in chips) 
Seat 6: L Loco (21804 in chips) 
Seat 8: Spyfus (5223 in chips) 
Seat 9: 1BigDave (10425 in chips) 
Spyfus: posts small blind 600
1BigDave: posts big blind 1200
*** HOLE CARDS ***
Dealt to Starstealer [2h 6d]
MrsConcrete: raises 1200 to 2400
tookdawg2000: folds 
Big Jag: folds 
FLHRIDER: calls 420 and is all-in
Starstealer: folds 
L Loco: folds 
Spyfus: folds 
1BigDave: folds 
*** FLOP *** [3s As 4c]
*** TURN *** [3s As 4c] [Jh]
*** RIVER *** [3s As 4c Jh] [5h]
*** SHOW DOWN ***
MrsConcrete: shows [9s 9d] (a pair of Nines)
MrsConcrete collected 1740 from side pot
FLHRIDER: shows [Kd Qs] (high card Ace)
MrsConcrete collected 1680 from main pot
*** SUMMARY ***
Total pot 3420 Main pot 1680. Side pot 1740. | Rake 0 
Board [3s As 4c Jh 5h]
Seat 1: MrsConcrete showed [9s 9d] and won (3420) with a pair of Nines
Seat 2: tookdawg2000 folded before Flop (didn't bet)
Seat 3: Big Jag folded before Flop (didn't bet)
Seat 4: FLHRIDER showed [Kd Qs] and lost with high card Ace
Seat 5: Starstealer folded before Flop (didn't bet)
Seat 6: L Loco (button) folded before Flop (didn't bet)
Seat 8: Spyfus (small blind) folded before Flop
Seat 9: 1BigDave (big blind) folded before Flop

*********** # 142 **************
PokerStars Game #136643903: Tournament #376033, Hold'em Limit - Level XI (1200/2400) - 2003/10/05 - 02:45:01 (ET)
Table '376033 11' Seat #8 is the button
Seat 1: MrsConcrete (21324 in chips) 
Seat 2: tookdawg2000 (33955 in chips) 
Seat 3: Big Jag (12858 in chips) 
Seat 5: Starstealer (8560 in chips) 
Seat 6: L Loco (21804 in chips) 
Seat 8: Spyfus (4623 in chips) 
Seat 9: 1BigDave (9225 in chips) 
1BigDave: posts small blind 600
MrsConcrete: posts big blind 1200
*** HOLE CARDS ***
Dealt to Starstealer [9d 6d]
tookdawg2000: folds 
Big Jag: raises 1200 to 2400
Starstealer: folds 
L Loco: folds 
Spyfus: folds 
1BigDave: folds 
MrsConcrete: folds 
baughman is connected 
Big Jag collected 3000 from  pot
Big Jag: doesn't show hand 
*** SUMMARY ***
Total pot 3000 | Rake 0 
Seat 1: MrsConcrete (big blind) folded before Flop
Seat 2: tookdawg2000 folded before Flop (didn't bet)
Seat 3: Big Jag collected (3000)
Seat 5: Starstealer folded before Flop (didn't bet)
Seat 6: L Loco folded before Flop (didn't bet)
Seat 8: Spyfus (button) folded before Flop (didn't bet)
Seat 9: 1BigDave (small blind) folded before Flop

*********** # 143 **************
PokerStars Game #136644262: Tournament #376033, Hold'em Limit - Level XI (1200/2400) - 2003/10/05 - 02:45:37 (ET)
Table '376033 11' Seat #9 is the button
Seat 1: MrsConcrete (20124 in chips) 
Seat 2: tookdawg2000 (33955 in chips) 
Seat 3: Big Jag (14658 in chips) 
Seat 4: baughman (15952 in chips) 
Seat 5: Starstealer (8560 in chips) 
Seat 6: L Loco (21804 in chips) 
Seat 8: Spyfus (4623 in chips) 
Seat 9: 1BigDave (8625 in chips) 
MrsConcrete: posts small blind 600
tookdawg2000: posts big blind 1200
*** HOLE CARDS ***
Dealt to Starstealer [9c 4h]
Big Jag: folds 
baughman: calls 1200
Starstealer: folds 
L Loco: folds 
Spyfus: folds 
1BigDave: folds 
MrsConcrete: folds 
tookdawg2000: checks 
*** FLOP *** [Qd 3c 5c]
tookdawg2000: checks 
baughman: bets 1200
tookdawg2000: calls 1200
*** TURN *** [Qd 3c 5c] [Kh]
tookdawg2000: checks 
baughman: checks 
*** RIVER *** [Qd 3c 5c Kh] [Kc]
tookdawg2000: bets 2400
baughman: calls 2400
*** SHOW DOWN ***
tookdawg2000: shows [2s 5d] (two pair, Kings and Fives)
baughman: shows [Ts Tc] (two pair, Kings and Tens)
baughman collected 10200 from  pot
*** SUMMARY ***
Total pot 10200 | Rake 0 
Board [Qd 3c 5c Kh Kc]
Seat 1: MrsConcrete (small blind) folded before Flop
Seat 2: tookdawg2000 (big blind) showed [2s 5d] and lost with two pair, Kings and Fives
Seat 3: Big Jag folded before Flop (didn't bet)
Seat 4: baughman showed [Ts Tc] and won (10200) with two pair, Kings and Tens
Seat 5: Starstealer folded before Flop (didn't bet)
Seat 6: L Loco folded before Flop (didn't bet)
Seat 8: Spyfus folded before Flop (didn't bet)
Seat 9: 1BigDave (button) folded before Flop (didn't bet)

*********** # 144 **************
PokerStars Game #136644654: Tournament #376033, Hold'em Limit - Level XI (1200/2400) - 2003/10/05 - 02:46:15 (ET)
Table '376033 11' Seat #1 is the button
Seat 1: MrsConcrete (19524 in chips) 
Seat 2: tookdawg2000 (29155 in chips) 
Seat 3: Big Jag (14658 in chips) 
Seat 4: baughman (21352 in chips) 
Seat 5: Starstealer (8560 in chips) 
Seat 6: L Loco (21804 in chips) 
Seat 7: A8deadman8A (15544 in chips) 
Seat 8: Spyfus (4623 in chips) 
Seat 9: 1BigDave (8625 in chips) 
tookdawg2000: posts small blind 600
Big Jag: posts big blind 1200
*** HOLE CARDS ***
Dealt to Starstealer [Jd 2s]
baughman: folds 
Starstealer: folds 
L Loco: calls 1200
A8deadman8A: folds 
Spyfus: folds 
1BigDave: folds 
MrsConcrete: folds 
tookdawg2000: calls 600
Big Jag: checks 
*** FLOP *** [4d Js 7c]
tookdawg2000: checks 
Big Jag: checks 
L Loco: checks 
*** TURN *** [4d Js 7c] [2d]
tookdawg2000: bets 2400
Big Jag: calls 2400
L Loco: folds 
*** RIVER *** [4d Js 7c 2d] [7h]
tookdawg2000: bets 2400
Big Jag: folds 
tookdawg2000 collected 8400 from  pot
tookdawg2000: doesn't show hand 
*** SUMMARY ***
Total pot 8400 | Rake 0 
Board [4d Js 7c 2d 7h]
Seat 1: MrsConcrete (button) folded before Flop (didn't bet)
Seat 2: tookdawg2000 (small blind) collected (8400)
Seat 3: Big Jag (big blind) folded on the River
Seat 4: baughman folded before Flop (didn't bet)
Seat 5: Starstealer folded before Flop (didn't bet)
Seat 6: L Loco folded on the Turn
Seat 7: A8deadman8A folded before Flop (didn't bet)
Seat 8: Spyfus folded before Flop (didn't bet)
Seat 9: 1BigDave folded before Flop (didn't bet)

*********** # 145 **************
PokerStars Game #136645112: Tournament #376033, Hold'em Limit - Level XI (1200/2400) - 2003/10/05 - 02:46:58 (ET)
Table '376033 11' Seat #2 is the button
Seat 1: MrsConcrete (19524 in chips) 
Seat 2: tookdawg2000 (33955 in chips) 
Seat 3: Big Jag (11058 in chips) 
Seat 4: baughman (21352 in chips) 
Seat 5: Starstealer (8560 in chips) 
Seat 6: L Loco (20604 in chips) 
Seat 7: A8deadman8A (15544 in chips) 
Seat 8: Spyfus (4623 in chips) 
Seat 9: 1BigDave (8625 in chips) 
Big Jag: posts small blind 600
baughman: posts big blind 1200
*** HOLE CARDS ***
Dealt to Starstealer [Jc Ah]
Starstealer: folds 
L Loco: folds 
A8deadman8A: folds 
Spyfus: folds 
1BigDave: raises 1200 to 2400
MrsConcrete: folds 
tookdawg2000: folds 
Big Jag: folds 
baughman: folds 
1BigDave collected 3000 from  pot
1BigDave: doesn't show hand 
*** SUMMARY ***
Total pot 3000 | Rake 0 
Seat 1: MrsConcrete folded before Flop (didn't bet)
Seat 2: tookdawg2000 (button) folded before Flop (didn't bet)
Seat 3: Big Jag (small blind) folded before Flop
Seat 4: baughman (big blind) folded before Flop
Seat 5: Starstealer folded before Flop (didn't bet)
Seat 6: L Loco folded before Flop (didn't bet)
Seat 7: A8deadman8A folded before Flop (didn't bet)
Seat 8: Spyfus folded before Flop (didn't bet)
Seat 9: 1BigDave collected (3000)

*********** # 146 **************
PokerStars Game #136645433: Tournament #376033, Hold'em Limit - Level XI (1200/2400) - 2003/10/05 - 02:47:30 (ET)
Table '376033 11' Seat #3 is the button
Seat 1: MrsConcrete (19524 in chips) 
Seat 2: tookdawg2000 (33955 in chips) 
Seat 3: Big Jag (10458 in chips) 
Seat 4: baughman (20152 in chips) 
Seat 5: Starstealer (8560 in chips) 
Seat 6: L Loco (20604 in chips) 
Seat 7: A8deadman8A (15544 in chips) 
Seat 8: Spyfus (4623 in chips) 
Seat 9: 1BigDave (10425 in chips) 
baughman: posts small blind 600
Starstealer: posts big blind 1200
*** HOLE CARDS ***
Dealt to Starstealer [Ah 5h]
L Loco: folds 
A8deadman8A: folds 
Spyfus: folds 
1BigDave: folds 
MrsConcrete: folds 
tookdawg2000: calls 1200
Big Jag: folds 
baughman: calls 600
Starstealer: checks 
*** FLOP *** [3c Td Qh]
baughman: checks 
Starstealer: bets 1200
tookdawg2000: calls 1200
baughman: folds 
*** TURN *** [3c Td Qh] [Jh]
Starstealer: bets 2400
tookdawg2000: calls 2400
*** RIVER *** [3c Td Qh Jh] [Js]
Starstealer: checks 
tookdawg2000: bets 2400
Starstealer: folds 
tookdawg2000 collected 10800 from  pot
tookdawg2000: shows [Jd Kd] (three of a kind, Jacks)
*** SUMMARY ***
Total pot 10800 | Rake 0 
Board [3c Td Qh Jh Js]
Seat 1: MrsConcrete folded before Flop (didn't bet)
Seat 2: tookdawg2000 collected (10800)
Seat 3: Big Jag (button) folded before Flop (didn't bet)
Seat 4: baughman (small blind) folded on the Flop
Seat 5: Starstealer (big blind) folded on the River
Seat 6: L Loco folded before Flop (didn't bet)
Seat 7: A8deadman8A folded before Flop (didn't bet)
Seat 8: Spyfus folded before Flop (didn't bet)
Seat 9: 1BigDave folded before Flop (didn't bet)

*********** # 147 **************
PokerStars Game #136646079: Tournament #376033, Hold'em Limit - Level XI (1200/2400) - 2003/10/05 - 02:48:35 (ET)
Table '376033 11' Seat #4 is the button
Seat 1: MrsConcrete (19524 in chips) 
Seat 2: tookdawg2000 (39955 in chips) 
Seat 3: Big Jag (10458 in chips) 
Seat 4: baughman (18952 in chips) 
Seat 5: Starstealer (3760 in chips) 
Seat 6: L Loco (20604 in chips) 
Seat 7: A8deadman8A (15544 in chips) 
Seat 8: Spyfus (4623 in chips) 
Seat 9: 1BigDave (10425 in chips) 
Starstealer: posts small blind 600
L Loco: posts big blind 1200
*** HOLE CARDS ***
Dealt to Starstealer [2s 5c]
A8deadman8A: folds 
Spyfus: folds 
1BigDave: folds 
MrsConcrete: folds 
tookdawg2000: calls 1200
Big Jag: folds 
baughman: folds 
Starstealer: folds 
L Loco: checks 
*** FLOP *** [6c 3s Jd]
L Loco: checks 
tookdawg2000: bets 1200
L Loco: folds 
tookdawg2000 collected 3000 from  pot
tookdawg2000: doesn't show hand 
*** SUMMARY ***
Total pot 3000 | Rake 0 
Board [6c 3s Jd]
Seat 1: MrsConcrete folded before Flop (didn't bet)
Seat 2: tookdawg2000 collected (3000)
Seat 3: Big Jag folded before Flop (didn't bet)
Seat 4: baughman (button) folded before Flop (didn't bet)
Seat 5: Starstealer (small blind) folded before Flop
Seat 6: L Loco (big blind) folded on the Flop
Seat 7: A8deadman8A folded before Flop (didn't bet)
Seat 8: Spyfus folded before Flop (didn't bet)
Seat 9: 1BigDave folded before Flop (didn't bet)

*********** # 148 **************
PokerStars Game #136646366: Tournament #376033, Hold'em Limit - Level XI (1200/2400) - 2003/10/05 - 02:49:01 (ET)
Table '376033 11' Seat #5 is the button
Seat 1: MrsConcrete (19524 in chips) 
Seat 2: tookdawg2000 (41755 in chips) 
Seat 3: Big Jag (10458 in chips) 
Seat 4: baughman (18952 in chips) 
Seat 5: Starstealer (3160 in chips) 
Seat 6: L Loco (19404 in chips) 
Seat 7: A8deadman8A (15544 in chips) 
Seat 8: Spyfus (4623 in chips) 
Seat 9: 1BigDave (10425 in chips) 
L Loco: posts small blind 600
A8deadman8A: posts big blind 1200
*** HOLE CARDS ***
Dealt to Starstealer [Td Jh]
Spyfus: folds 
1BigDave: folds 
MrsConcrete: folds 
tookdawg2000: folds 
Big Jag: folds 
baughman: folds 
Starstealer: folds 
L Loco: folds 
A8deadman8A collected 1200 from  pot
A8deadman8A: doesn't show hand 
*** SUMMARY ***
Total pot 1200 | Rake 0 
Seat 1: MrsConcrete folded before Flop (didn't bet)
Seat 2: tookdawg2000 folded before Flop (didn't bet)
Seat 3: Big Jag folded before Flop (didn't bet)
Seat 4: baughman folded before Flop (didn't bet)
Seat 5: Starstealer (button) folded before Flop (didn't bet)
Seat 6: L Loco (small blind) folded before Flop
Seat 7: A8deadman8A (big blind) collected (1200)
Seat 8: Spyfus folded before Flop (didn't bet)
Seat 9: 1BigDave folded before Flop (didn't bet)

*********** # 149 **************
PokerStars Game #136646598: Tournament #376033, Hold'em Limit - Level XI (1200/2400) - 2003/10/05 - 02:49:25 (ET)
Table '376033 11' Seat #6 is the button
Seat 1: MrsConcrete (19524 in chips) 
Seat 2: tookdawg2000 (41755 in chips) 
Seat 3: Big Jag (10458 in chips) 
Seat 4: baughman (18952 in chips) 
Seat 5: Starstealer (3160 in chips) 
Seat 6: L Loco (18804 in chips) 
Seat 7: A8deadman8A (16144 in chips) 
Seat 8: Spyfus (4623 in chips) 
Seat 9: 1BigDave (10425 in chips) 
A8deadman8A: posts small blind 600
Spyfus: posts big blind 1200
*** HOLE CARDS ***
Dealt to Starstealer [Ts 7s]
1BigDave: folds 
MrsConcrete: folds 
tookdawg2000: folds 
Big Jag: folds 
baughman: folds 
Starstealer: folds 
L Loco: calls 1200
A8deadman8A: calls 600
Spyfus: checks 
*** FLOP *** [7c Tc 8d]
A8deadman8A: bets 1200
Spyfus: folds 
L Loco: calls 1200
*** TURN *** [7c Tc 8d] [Jc]
A8deadman8A: bets 2400
L Loco: calls 2400
*** RIVER *** [7c Tc 8d Jc] [Ks]
A8deadman8A: bets 2400
L Loco: calls 2400
*** SHOW DOWN ***
A8deadman8A: shows [Kc Qc] (a flush, King high)
L Loco: mucks hand 
A8deadman8A collected 15600 from  pot
*** SUMMARY ***
Total pot 15600 | Rake 0 
Board [7c Tc 8d Jc Ks]
Seat 1: MrsConcrete folded before Flop (didn't bet)
Seat 2: tookdawg2000 folded before Flop (didn't bet)
Seat 3: Big Jag folded before Flop (didn't bet)
Seat 4: baughman folded before Flop (didn't bet)
Seat 5: Starstealer folded before Flop (didn't bet)
Seat 6: L Loco (button) mucked [Ac Js] - a pair of Jacks
Seat 7: A8deadman8A (small blind) showed [Kc Qc] and won (15600) with a flush, King high
Seat 8: Spyfus (big blind) folded on the Flop
Seat 9: 1BigDave folded before Flop (didn't bet)

*********** # 150 **************
PokerStars Game #136647194: Tournament #376033, Hold'em Limit - Level XI (1200/2400) - 2003/10/05 - 02:50:23 (ET)
Table '376033 11' Seat #7 is the button
Seat 1: MrsConcrete (19524 in chips) 
Seat 2: tookdawg2000 (41755 in chips) 
Seat 3: Big Jag (10458 in chips) 
Seat 4: baughman (18952 in chips) 
Seat 5: Starstealer (3160 in chips) 
Seat 6: L Loco (11604 in chips) 
Seat 7: A8deadman8A (24544 in chips) 
Seat 8: Spyfus (3423 in chips) 
Seat 9: 1BigDave (10425 in chips) 
Spyfus: posts small blind 600
1BigDave: posts big blind 1200
*** HOLE CARDS ***
Dealt to Starstealer [7d 8d]
MrsConcrete: folds 
tookdawg2000: calls 1200
Big Jag: folds 
baughman: raises 1200 to 2400
Starstealer: folds 
L Loco: folds 
A8deadman8A: folds 
Spyfus: folds 
1BigDave: folds 
tookdawg2000: calls 1200
*** FLOP *** [6h 5s 3s]
tookdawg2000: checks 
baughman: bets 1200
tookdawg2000: calls 1200
*** TURN *** [6h 5s 3s] [Jh]
tookdawg2000: checks 
baughman: checks 
*** RIVER *** [6h 5s 3s Jh] [Tc]
tookdawg2000: bets 2400
baughman: calls 2400
*** SHOW DOWN ***
tookdawg2000: shows [9h Th] (a pair of Tens)
baughman: mucks hand 
tookdawg2000 collected 13800 from  pot
*** SUMMARY ***
Total pot 13800 | Rake 0 
Board [6h 5s 3s Jh Tc]
Seat 1: MrsConcrete folded before Flop (didn't bet)
Seat 2: tookdawg2000 showed [9h Th] and won (13800) with a pair of Tens
Seat 3: Big Jag folded before Flop (didn't bet)
Seat 4: baughman mucked [Kc As] - high card Ace
Seat 5: Starstealer folded before Flop (didn't bet)
Seat 6: L Loco folded before Flop (didn't bet)
Seat 7: A8deadman8A (button) folded before Flop (didn't bet)
Seat 8: Spyfus (small blind) folded before Flop
Seat 9: 1BigDave (big blind) folded before Flop

*********** # 151 **************
PokerStars Game #136647779: Tournament #376033, Hold'em Limit - Level XI (1200/2400) - 2003/10/05 - 02:51:19 (ET)
Table '376033 11' Seat #8 is the button
Seat 1: MrsConcrete (19524 in chips) 
Seat 2: tookdawg2000 (49555 in chips) 
Seat 3: Big Jag (10458 in chips) 
Seat 4: baughman (12952 in chips) 
Seat 5: Starstealer (3160 in chips) 
Seat 6: L Loco (11604 in chips) 
Seat 7: A8deadman8A (24544 in chips) 
Seat 8: Spyfus (2823 in chips) 
Seat 9: 1BigDave (9225 in chips) 
1BigDave: posts small blind 600
MrsConcrete: posts big blind 1200
*** HOLE CARDS ***
Dealt to Starstealer [7s 2d]
tookdawg2000: folds 
Big Jag: folds 
baughman: folds 
Starstealer: folds 
L Loco: folds 
A8deadman8A: folds 
Spyfus: folds 
1BigDave: folds 
MrsConcrete collected 1200 from  pot
*** SUMMARY ***
Total pot 1200 | Rake 0 
Seat 1: MrsConcrete (big blind) collected (1200)
Seat 2: tookdawg2000 folded before Flop (didn't bet)
Seat 3: Big Jag folded before Flop (didn't bet)
Seat 4: baughman folded before Flop (didn't bet)
Seat 5: Starstealer folded before Flop (didn't bet)
Seat 6: L Loco folded before Flop (didn't bet)
Seat 7: A8deadman8A folded before Flop (didn't bet)
Seat 8: Spyfus (button) folded before Flop (didn't bet)
Seat 9: 1BigDave (small blind) folded before Flop

*********** # 152 **************
PokerStars Game #136648054: Tournament #376033, Hold'em Limit - Level XI (1200/2400) - 2003/10/05 - 02:51:45 (ET)
Table '376033 11' Seat #9 is the button
Seat 1: MrsConcrete (20124 in chips) 
Seat 2: tookdawg2000 (49555 in chips) 
Seat 3: Big Jag (10458 in chips) 
Seat 4: baughman (12952 in chips) 
Seat 5: Starstealer (3160 in chips) 
Seat 6: L Loco (11604 in chips) 
Seat 7: A8deadman8A (24544 in chips) 
Seat 8: Spyfus (2823 in chips) 
Seat 9: 1BigDave (8625 in chips) 
MrsConcrete: posts small blind 600
tookdawg2000: posts big blind 1200
*** HOLE CARDS ***
Dealt to Starstealer [Kh Tc]
Big Jag: folds 
baughman: folds 
Starstealer: folds 
L Loco: folds 
A8deadman8A: folds 
Spyfus: folds 
1BigDave: folds 
MrsConcrete: folds 
tookdawg2000 collected 1200 from  pot
tookdawg2000: doesn't show hand 
*** SUMMARY ***
Total pot 1200 | Rake 0 
Seat 1: MrsConcrete (small blind) folded before Flop
Seat 2: tookdawg2000 (big blind) collected (1200)
Seat 3: Big Jag folded before Flop (didn't bet)
Seat 4: baughman folded before Flop (didn't bet)
Seat 5: Starstealer folded before Flop (didn't bet)
Seat 6: L Loco folded before Flop (didn't bet)
Seat 7: A8deadman8A folded before Flop (didn't bet)
Seat 8: Spyfus folded before Flop (didn't bet)
Seat 9: 1BigDave (button) folded before Flop (didn't bet)

*********** # 153 **************
PokerStars Game #136648437: Tournament #376033, Hold'em Limit - Level XI (1200/2400) - 2003/10/05 - 02:52:23 (ET)
Table '376033 11' Seat #1 is the button
Seat 1: MrsConcrete (19524 in chips) 
Seat 2: tookdawg2000 (50155 in chips) 
Seat 3: Big Jag (10458 in chips) 
Seat 4: baughman (12952 in chips) 
Seat 5: Starstealer (3160 in chips) 
Seat 6: L Loco (11604 in chips) 
Seat 7: A8deadman8A (24544 in chips) 
Seat 8: Spyfus (2823 in chips) 
Seat 9: 1BigDave (8625 in chips) 
tookdawg2000: posts small blind 600
Big Jag: posts big blind 1200
*** HOLE CARDS ***
Dealt to Starstealer [Qh 5s]
baughman: calls 1200
Starstealer: folds 
L Loco: calls 1200
A8deadman8A: folds 
Spyfus: folds 
1BigDave: folds 
MrsConcrete: folds 
tookdawg2000: calls 600
Big Jag: checks 
*** FLOP *** [Jd 2d Ts]
tookdawg2000: checks 
Big Jag: checks 
baughman: bets 1200
L Loco: folds 
tookdawg2000: folds 
Big Jag: calls 1200
*** TURN *** [Jd 2d Ts] [Jh]
Big Jag: checks 
baughman: bets 2400
Big Jag: folds 
baughman collected 7200 from  pot
baughman: doesn't show hand 
*** SUMMARY ***
Total pot 7200 | Rake 0 
Board [Jd 2d Ts Jh]
Seat 1: MrsConcrete (button) folded before Flop (didn't bet)
Seat 2: tookdawg2000 (small blind) folded on the Flop
Seat 3: Big Jag (big blind) folded on the Turn
Seat 4: baughman collected (7200)
Seat 5: Starstealer folded before Flop (didn't bet)
Seat 6: L Loco folded on the Flop
Seat 7: A8deadman8A folded before Flop (didn't bet)
Seat 8: Spyfus folded before Flop (didn't bet)
Seat 9: 1BigDave folded before Flop (didn't bet)

*********** # 154 **************
PokerStars Game #136649117: Tournament #376033, Hold'em Limit - Level XI (1200/2400) - 2003/10/05 - 02:53:31 (ET)
Table '376033 11' Seat #2 is the button
Seat 1: MrsConcrete (19524 in chips) 
Seat 2: tookdawg2000 (48955 in chips) 
Seat 3: Big Jag (8058 in chips) 
Seat 4: baughman (17752 in chips) 
Seat 5: Starstealer (3160 in chips) 
Seat 7: A8deadman8A (24544 in chips) 
Seat 8: Spyfus (2823 in chips) 
Seat 9: 1BigDave (8625 in chips) 
Big Jag: posts small blind 600
baughman: posts big blind 1200
*** HOLE CARDS ***
Dealt to Starstealer [Qd Jc]
Starstealer: folds 
A8deadman8A: folds 
Spyfus: folds 
1BigDave: folds 
MrsConcrete: folds 
tookdawg2000: folds 
Big Jag: calls 600
baughman: checks 
*** FLOP *** [Kh Ac Th]
Big Jag: checks 
baughman: checks 
*** TURN *** [Kh Ac Th] [Ts]
Big Jag: checks 
baughman: bets 2400
Big Jag: calls 2400
*** RIVER *** [Kh Ac Th Ts] [3h]
Big Jag: checks 
baughman: bets 2400
Big Jag: folds 
baughman collected 7200 from  pot
baughman: doesn't show hand 
*** SUMMARY ***
Total pot 7200 | Rake 0 
Board [Kh Ac Th Ts 3h]
Seat 1: MrsConcrete folded before Flop (didn't bet)
Seat 2: tookdawg2000 (button) folded before Flop (didn't bet)
Seat 3: Big Jag (small blind) folded on the River
Seat 4: baughman (big blind) collected (7200)
Seat 5: Starstealer folded before Flop (didn't bet)
Seat 7: A8deadman8A folded before Flop (didn't bet)
Seat 8: Spyfus folded before Flop (didn't bet)
Seat 9: 1BigDave folded before Flop (didn't bet)

*********** # 155 **************
PokerStars Game #136649811: Tournament #376033, Hold'em Limit - Level XI (1200/2400) - 2003/10/05 - 02:54:40 (ET)
Table '376033 11' Seat #3 is the button
Seat 1: MrsConcrete (19524 in chips) 
Seat 2: tookdawg2000 (48955 in chips) 
Seat 3: Big Jag (4458 in chips) 
Seat 4: baughman (21352 in chips) 
Seat 5: Starstealer (3160 in chips) 
Seat 7: A8deadman8A (24544 in chips) 
Seat 8: Spyfus (2823 in chips) 
Seat 9: 1BigDave (8625 in chips) 
baughman: posts small blind 600
Starstealer: posts big blind 1200
*** HOLE CARDS ***
Dealt to Starstealer [5s 3h]
A8deadman8A: folds 
Spyfus: folds 
1BigDave: folds 
MrsConcrete: folds 
tookdawg2000: folds 
Big Jag: folds 
baughman: raises 1200 to 2400
Starstealer: folds 
baughman collected 2400 from  pot
baughman: doesn't show hand 
*** SUMMARY ***
Total pot 2400 | Rake 0 
Seat 1: MrsConcrete folded before Flop (didn't bet)
Seat 2: tookdawg2000 folded before Flop (didn't bet)
Seat 3: Big Jag (button) folded before Flop (didn't bet)
Seat 4: baughman (small blind) collected (2400)
Seat 5: Starstealer (big blind) folded before Flop
Seat 7: A8deadman8A folded before Flop (didn't bet)
Seat 8: Spyfus folded before Flop (didn't bet)
Seat 9: 1BigDave folded before Flop (didn't bet)

*********** # 156 **************
PokerStars Game #136650806: Tournament #376033, Hold'em Limit - Level XI (1200/2400) - 2003/10/05 - 02:56:19 (ET)
Table '376033 11' Seat #4 is the button
Seat 1: MrsConcrete (19524 in chips) 
Seat 2: tookdawg2000 (48955 in chips) 
Seat 3: Big Jag (4458 in chips) 
Seat 4: baughman (22552 in chips) 
Seat 5: Starstealer (1960 in chips) 
Seat 7: A8deadman8A (24544 in chips) 
Seat 8: Spyfus (2823 in chips) 
Seat 9: 1BigDave (8625 in chips) 
Starstealer: posts small blind 600
A8deadman8A: posts big blind 1200
*** HOLE CARDS ***
Dealt to Starstealer [2c 4c]
Spyfus: folds 
1BigDave: folds 
MrsConcrete: folds 
tookdawg2000: folds 
Big Jag: folds 
baughman: folds 
Starstealer: folds 
A8deadman8A collected 1200 from  pot
A8deadman8A: doesn't show hand 
*** SUMMARY ***
Total pot 1200 | Rake 0 
Seat 1: MrsConcrete folded before Flop (didn't bet)
Seat 2: tookdawg2000 folded before Flop (didn't bet)
Seat 3: Big Jag folded before Flop (didn't bet)
Seat 4: baughman (button) folded before Flop (didn't bet)
Seat 5: Starstealer (small blind) folded before Flop
Seat 7: A8deadman8A (big blind) collected (1200)
Seat 8: Spyfus folded before Flop (didn't bet)
Seat 9: 1BigDave folded before Flop (didn't bet)

*********** # 157 **************
PokerStars Game #136651637: Tournament #376033, Hold'em Limit - Level XII (2000/4000) - 2003/10/05 - 02:57:42 (ET)
Table '376033 11' Seat #5 is the button
Seat 1: MrsConcrete (19524 in chips) 
Seat 2: tookdawg2000 (48955 in chips) 
Seat 3: Big Jag (4458 in chips) 
Seat 4: baughman (22552 in chips) 
Seat 5: Starstealer (1360 in chips) 
Seat 7: A8deadman8A (25144 in chips) 
Seat 8: Spyfus (2823 in chips) 
Seat 9: 1BigDave (8625 in chips) 
A8deadman8A: posts small blind 1000
Spyfus: posts big blind 2000
*** HOLE CARDS ***
Dealt to Starstealer [Ks Ad]
1BigDave: folds 
MrsConcrete: folds 
Iggy23 [observer] said, "hey star...tourney is starting soon if you wanna get in"
tookdawg2000: folds 
Big Jag: folds 
baughman: folds 
Starstealer: calls 1360 and is all-in
A8deadman8A: calls 1000
Spyfus: checks 
*** FLOP *** [Js 9c 6c]
A8deadman8A: checks 
Spyfus: bets 823 and is all-in
A8deadman8A: calls 823
*** TURN *** [Js 9c 6c] [Qd]
*** RIVER *** [Js 9c 6c Qd] [Tc]
*** SHOW DOWN ***
A8deadman8A: shows [7h 8d] (a straight, Eight to Queen)
Spyfus: shows [3h Jc] (a pair of Jacks)
A8deadman8A collected 2926 from side pot
Starstealer: shows [Ks Ad] (a straight, Ten to Ace)
Starstealer collected 4080 from main pot
PlanetMars is connected 
*** SUMMARY ***
Total pot 7006 Main pot 4080. Side pot 2926. | Rake 0 
Board [Js 9c 6c Qd Tc]
Seat 1: MrsConcrete folded before Flop (didn't bet)
Seat 2: tookdawg2000 folded before Flop (didn't bet)
Seat 3: Big Jag folded before Flop (didn't bet)
Seat 4: baughman folded before Flop (didn't bet)
Seat 5: Starstealer (button) showed [Ks Ad] and won (4080) with a straight, Ten to Ace
Seat 7: A8deadman8A (small blind) showed [7h 8d] and won (2926) with a straight, Eight to Queen
Seat 8: Spyfus (big blind) showed [3h Jc] and lost with a pair of Jacks
Seat 9: 1BigDave folded before Flop (didn't bet)

*********** # 158 **************
PokerStars Game #136652501: Tournament #376033, Hold'em Limit - Level XII (2000/4000) - 2003/10/05 - 02:59:09 (ET)
Table '376033 11' Seat #7 is the button
Seat 1: MrsConcrete (19524 in chips) 
Seat 2: tookdawg2000 (48955 in chips) 
Seat 3: Big Jag (4458 in chips) 
Seat 4: baughman (22552 in chips) 
Seat 5: Starstealer (4080 in chips) 
Seat 6: PlanetMars (24280 in chips) 
Seat 7: A8deadman8A (25247 in chips) 
Seat 9: 1BigDave (8625 in chips) 
1BigDave: posts small blind 1000
MrsConcrete: posts big blind 2000
*** HOLE CARDS ***
Dealt to Starstealer [3c 2h]
tookdawg2000: folds 
Big Jag: folds 
baughman: folds 
Starstealer: folds 
PlanetMars: folds 
A8deadman8A: folds 
1BigDave: folds 
MrsConcrete collected 2000 from  pot
*** SUMMARY ***
Total pot 2000 | Rake 0 
Seat 1: MrsConcrete (big blind) collected (2000)
Seat 2: tookdawg2000 folded before Flop (didn't bet)
Seat 3: Big Jag folded before Flop (didn't bet)
Seat 4: baughman folded before Flop (didn't bet)
Seat 5: Starstealer folded before Flop (didn't bet)
Seat 6: PlanetMars folded before Flop (didn't bet)
Seat 7: A8deadman8A (button) folded before Flop (didn't bet)
Seat 9: 1BigDave (small blind) folded before Flop

*********** # 159 **************
PokerStars Game #136652798: Tournament #376033, Hold'em Limit - Level XII (2000/4000) - 2003/10/05 - 02:59:39 (ET)
Table '376033 11' Seat #9 is the button
Seat 1: MrsConcrete (20524 in chips) 
Seat 2: tookdawg2000 (48955 in chips) 
Seat 3: Big Jag (4458 in chips) 
Seat 4: baughman (22552 in chips) 
Seat 5: Starstealer (4080 in chips) 
Seat 6: PlanetMars (24280 in chips) 
Seat 7: A8deadman8A (25247 in chips) 
Seat 9: 1BigDave (7625 in chips) 
MrsConcrete: posts small blind 1000
tookdawg2000: posts big blind 2000
*** HOLE CARDS ***
Dealt to Starstealer [2h 9d]
Big Jag: folds 
baughman: folds 
Starstealer: folds 
PlanetMars: folds 
A8deadman8A: folds 
1BigDave: folds 
MrsConcrete: folds 
tookdawg2000 collected 2000 from  pot
*** SUMMARY ***
Total pot 2000 | Rake 0 
Seat 1: MrsConcrete (small blind) folded before Flop
Seat 2: tookdawg2000 (big blind) collected (2000)
Seat 3: Big Jag folded before Flop (didn't bet)
Seat 4: baughman folded before Flop (didn't bet)
Seat 5: Starstealer folded before Flop (didn't bet)
Seat 6: PlanetMars folded before Flop (didn't bet)
Seat 7: A8deadman8A folded before Flop (didn't bet)
Seat 9: 1BigDave (button) folded before Flop (didn't bet)

*********** # 160 **************
PokerStars Game #136652999: Tournament #376033, Hold'em Limit - Level XII (2000/4000) - 2003/10/05 - 02:59:59 (ET)
Table '376033 11' Seat #1 is the button
Seat 1: MrsConcrete (19524 in chips) 
Seat 2: tookdawg2000 (49955 in chips) 
Seat 3: Big Jag (4458 in chips) 
Seat 4: baughman (22552 in chips) 
Seat 5: Starstealer (4080 in chips) 
Seat 6: PlanetMars (24280 in chips) 
Seat 7: A8deadman8A (25247 in chips) 
Seat 9: 1BigDave (7625 in chips) 
tookdawg2000: posts small blind 1000
Big Jag: posts big blind 2000
*** HOLE CARDS ***
Dealt to Starstealer [Ah 3c]
baughman: folds 
Starstealer: folds 
PlanetMars: folds 
A8deadman8A: calls 2000
1BigDave: folds 
MrsConcrete: folds 
tookdawg2000: folds 
Big Jag: checks 
*** FLOP *** [Js Qc Td]
Big Jag: checks 
A8deadman8A: bets 2000
Big Jag: calls 2000
*** TURN *** [Js Qc Td] [6s]
Big Jag: checks 
A8deadman8A: bets 4000
Big Jag: calls 458 and is all-in
*** RIVER *** [Js Qc Td 6s] [9s]
*** SHOW DOWN ***
Big Jag: shows [Kd 5c] (a straight, Nine to King)
A8deadman8A: shows [2c 2h] (a pair of Deuces)
Big Jag collected 9916 from  pot
*** SUMMARY ***
Total pot 9916 | Rake 0 
Board [Js Qc Td 6s 9s]
Seat 1: MrsConcrete (button) folded before Flop (didn't bet)
Seat 2: tookdawg2000 (small blind) folded before Flop
Seat 3: Big Jag (big blind) showed [Kd 5c] and won (9916) with a straight, Nine to King
Seat 4: baughman folded before Flop (didn't bet)
Seat 5: Starstealer folded before Flop (didn't bet)
Seat 6: PlanetMars folded before Flop (didn't bet)
Seat 7: A8deadman8A showed [2c 2h] and lost with a pair of Deuces
Seat 9: 1BigDave folded before Flop (didn't bet)

*********** # 161 **************
PokerStars Game #136654356: Tournament #376033, Hold'em Limit - Level XII (2000/4000) - 2003/10/05 - 03:01:20 (ET)
Table '376033 11' Seat #2 is the button
Seat 1: MrsConcrete (19524 in chips) 
Seat 2: tookdawg2000 (48955 in chips) 
Seat 3: Big Jag (9916 in chips) 
Seat 4: baughman (22552 in chips) 
Seat 5: Starstealer (4080 in chips) 
Seat 6: PlanetMars (24280 in chips) 
Seat 7: A8deadman8A (20789 in chips) 
Seat 9: 1BigDave (7625 in chips) 
Big Jag: posts small blind 1000
baughman: posts big blind 2000
*** HOLE CARDS ***
Dealt to Starstealer [4h 6h]
Starstealer: folds 
PlanetMars: folds 
A8deadman8A: folds 
1BigDave: folds 
MrsConcrete: folds 
tookdawg2000: folds 
Big Jag: folds 
baughman collected 2000 from  pot
baughman: doesn't show hand 
*** SUMMARY ***
Total pot 2000 | Rake 0 
Seat 1: MrsConcrete folded before Flop (didn't bet)
Seat 2: tookdawg2000 (button) folded before Flop (didn't bet)
Seat 3: Big Jag (small blind) folded before Flop
Seat 4: baughman (big blind) collected (2000)
Seat 5: Starstealer folded before Flop (didn't bet)
Seat 6: PlanetMars folded before Flop (didn't bet)
Seat 7: A8deadman8A folded before Flop (didn't bet)
Seat 9: 1BigDave folded before Flop (didn't bet)

*********** # 162 **************
PokerStars Game #136654821: Tournament #376033, Hold'em Limit - Level XII (2000/4000) - 2003/10/05 - 03:01:51 (ET)
Table '376033 11' Seat #3 is the button
Seat 1: MrsConcrete (19524 in chips) 
Seat 2: tookdawg2000 (48955 in chips) 
Seat 3: Big Jag (8916 in chips) 
Seat 4: baughman (23552 in chips) 
Seat 5: Starstealer (4080 in chips) 
Seat 6: PlanetMars (24280 in chips) 
Seat 7: A8deadman8A (20789 in chips) 
Seat 9: 1BigDave (7625 in chips) 
baughman: posts small blind 1000
Starstealer: posts big blind 2000
*** HOLE CARDS ***
Dealt to Starstealer [6s Ad]
PlanetMars: folds 
A8deadman8A: folds 
1BigDave: folds 
MrsConcrete: folds 
tookdawg2000: folds 
Big Jag: folds 
baughman: raises 2000 to 4000
Starstealer: folds 
Mysterion8 is connected 
baughman collected 4000 from  pot
baughman: doesn't show hand 
*** SUMMARY ***
Total pot 4000 | Rake 0 
Seat 1: MrsConcrete folded before Flop (didn't bet)
Seat 2: tookdawg2000 folded before Flop (didn't bet)
Seat 3: Big Jag (button) folded before Flop (didn't bet)
Seat 4: baughman (small blind) collected (4000)
Seat 5: Starstealer (big blind) folded before Flop
Seat 6: PlanetMars folded before Flop (didn't bet)
Seat 7: A8deadman8A folded before Flop (didn't bet)
Seat 9: 1BigDave folded before Flop (didn't bet)

*********** # 163 **************
PokerStars Game #136655573: Tournament #376033, Hold'em Limit - Level XII (2000/4000) - 2003/10/05 - 03:02:44 (ET)
Table '376033 11' Seat #4 is the button
Seat 1: MrsConcrete (19524 in chips) 
Seat 2: tookdawg2000 (48955 in chips) 
Seat 3: Big Jag (8916 in chips) 
Seat 4: baughman (25552 in chips) 
Seat 5: Starstealer (2080 in chips) 
Seat 6: PlanetMars (24280 in chips) 
Seat 7: A8deadman8A (20789 in chips) 
Seat 8: Mysterion8 (42938 in chips) 
Seat 9: 1BigDave (7625 in chips) 
Starstealer: posts small blind 1000
PlanetMars: posts big blind 2000
*** HOLE CARDS ***
Dealt to Starstealer [4s 2d]
A8deadman8A: folds 
Mysterion8: folds 
1BigDave: folds 
MrsConcrete: folds 
tookdawg2000: folds 
Big Jag: folds 
baughman: folds 
Starstealer: folds 
PlanetMars collected 2000 from  pot
PlanetMars: doesn't show hand 
*** SUMMARY ***
Total pot 2000 | Rake 0 
Seat 1: MrsConcrete folded before Flop (didn't bet)
Seat 2: tookdawg2000 folded before Flop (didn't bet)
Seat 3: Big Jag folded before Flop (didn't bet)
Seat 4: baughman (button) folded before Flop (didn't bet)
Seat 5: Starstealer (small blind) folded before Flop
Seat 6: PlanetMars (big blind) collected (2000)
Seat 7: A8deadman8A folded before Flop (didn't bet)
Seat 8: Mysterion8 folded before Flop (didn't bet)
Seat 9: 1BigDave folded before Flop (didn't bet)

*********** # 164 **************
PokerStars Game #136655978: Tournament #376033, Hold'em Limit - Level XII (2000/4000) - 2003/10/05 - 03:03:14 (ET)
Table '376033 11' Seat #5 is the button
Seat 1: MrsConcrete (19524 in chips) 
Seat 2: tookdawg2000 (48955 in chips) 
Seat 3: Big Jag (8916 in chips) 
Seat 4: baughman (25552 in chips) 
Seat 5: Starstealer (1080 in chips) 
Seat 6: PlanetMars (25280 in chips) 
Seat 7: A8deadman8A (20789 in chips) 
Seat 8: Mysterion8 (42938 in chips) 
Seat 9: 1BigDave (7625 in chips) 
PlanetMars: posts small blind 1000
A8deadman8A: posts big blind 2000
*** HOLE CARDS ***
Dealt to Starstealer [Qc 4s]
PlanetMars said, "thanks :)"
Mysterion8: folds 
1BigDave: folds 
MrsConcrete: folds 
tookdawg2000: folds 
Big Jag: folds 
baughman: folds 
Starstealer: folds 
PlanetMars: folds 
A8deadman8A collected 2000 from  pot
A8deadman8A: doesn't show hand 
*** SUMMARY ***
Total pot 2000 | Rake 0 
Seat 1: MrsConcrete folded before Flop (didn't bet)
Seat 2: tookdawg2000 folded before Flop (didn't bet)
Seat 3: Big Jag folded before Flop (didn't bet)
Seat 4: baughman folded before Flop (didn't bet)
Seat 5: Starstealer (button) folded before Flop (didn't bet)
Seat 6: PlanetMars (small blind) folded before Flop
Seat 7: A8deadman8A (big blind) collected (2000)
Seat 8: Mysterion8 folded before Flop (didn't bet)
Seat 9: 1BigDave folded before Flop (didn't bet)

*********** # 165 **************
PokerStars Game #136656560: Tournament #376033, Hold'em Limit - Level XII (2000/4000) - 2003/10/05 - 03:03:55 (ET)
Table '376033 11' Seat #6 is the button
Seat 1: MrsConcrete (19524 in chips) 
Seat 2: tookdawg2000 (48955 in chips) 
Seat 3: Big Jag (8916 in chips) 
Seat 4: baughman (25552 in chips) 
Seat 5: Starstealer (1080 in chips) 
Seat 6: PlanetMars (24280 in chips) 
Seat 7: A8deadman8A (21789 in chips) 
Seat 8: Mysterion8 (42938 in chips) 
Seat 9: 1BigDave (7625 in chips) 
A8deadman8A: posts small blind 1000
Mysterion8: posts big blind 2000
*** HOLE CARDS ***
Dealt to Starstealer [8d 4s]
1BigDave: folds 
MrsConcrete: raises 2000 to 4000
tookdawg2000: folds 
Big Jag: folds 
baughman: folds 
Starstealer: folds 
PlanetMars: folds 
A8deadman8A: folds 
Mysterion8: folds 
MrsConcrete collected 5000 from  pot
*** SUMMARY ***
Total pot 5000 | Rake 0 
Seat 1: MrsConcrete collected (5000)
Seat 2: tookdawg2000 folded before Flop (didn't bet)
Seat 3: Big Jag folded before Flop (didn't bet)
Seat 4: baughman folded before Flop (didn't bet)
Seat 5: Starstealer folded before Flop (didn't bet)
Seat 6: PlanetMars (button) folded before Flop (didn't bet)
Seat 7: A8deadman8A (small blind) folded before Flop
Seat 8: Mysterion8 (big blind) folded before Flop
Seat 9: 1BigDave folded before Flop (didn't bet)

*********** # 166 **************
PokerStars Game #136657011: Tournament #376033, Hold'em Limit - Level XII (2000/4000) - 2003/10/05 - 03:04:27 (ET)
Table '376033 11' Seat #7 is the button
Seat 1: MrsConcrete (22524 in chips) 
Seat 2: tookdawg2000 (48955 in chips) 
Seat 3: Big Jag (8916 in chips) 
Seat 4: baughman (25552 in chips) 
Seat 5: Starstealer (1080 in chips) 
Seat 6: PlanetMars (24280 in chips) 
Seat 7: A8deadman8A (20789 in chips) 
Seat 8: Mysterion8 (40938 in chips) 
Seat 9: 1BigDave (7625 in chips) 
Mysterion8: posts small blind 1000
1BigDave: posts big blind 2000
*** HOLE CARDS ***
Dealt to Starstealer [4d 4h]
MrsConcrete: folds 
tookdawg2000: calls 2000
Big Jag: folds 
baughman: folds 
Starstealer: calls 1080 and is all-in
PlanetMars: folds 
A8deadman8A: calls 2000
Mysterion8: calls 1000
1BigDave: checks 
*** FLOP *** [Tc 5s 3c]
Mysterion8: bets 2000
1BigDave: folds 
tookdawg2000: calls 2000
A8deadman8A: folds 
*** TURN *** [Tc 5s 3c] [Js]
Mysterion8: bets 4000
tookdawg2000: calls 4000
*** RIVER *** [Tc 5s 3c Js] [Qs]
Mysterion8: checks 
tookdawg2000: bets 4000
Mysterion8: calls 4000
*** SHOW DOWN ***
tookdawg2000: shows [Jh Ad] (a pair of Jacks)
Mysterion8: shows [Td Kc] (a pair of Tens)
tookdawg2000 collected 23680 from side pot
Starstealer: mucks hand 
tookdawg2000 collected 5400 from main pot
*** SUMMARY ***
Total pot 29080 Main pot 5400. Side pot 23680. | Rake 0 
Board [Tc 5s 3c Js Qs]
Seat 1: MrsConcrete folded before Flop (didn't bet)
Seat 2: tookdawg2000 showed [Jh Ad] and won (29080) with a pair of Jacks
Seat 3: Big Jag folded before Flop (didn't bet)
Seat 4: baughman folded before Flop (didn't bet)
Seat 5: Starstealer mucked [4d 4h] - a pair of Fours
Seat 6: PlanetMars folded before Flop (didn't bet)
Seat 7: A8deadman8A (button) folded on the Flop
Seat 8: Mysterion8 (small blind) showed [Td Kc] and lost with a pair of Tens
Seat 9: 1BigDave (big blind) folded on the Flop

If you have any questions, please contact us at support@pokerstars.com
 